30 100
TAAGGGGTACAAATTCTGAGGAGTTTATTC|AGTCTATTCGGATTGACGCAAGTGAAATCA
GATTTACGGGAGATATAACAGAGCACCGCG|AGACAGTCTACTGACTGTGAACATATCCAC
TTGAGATATAACAGAGCACCGCGGAACGGG|GTTGGCCTACGTATAAATGCTGGGCAAGCA
ACAGAGCACCGCGGAACGGAATCCGCCTTA|ACGGTATTTTTGAGATATAACAGAGCACCG
TGCTCATATCCTGGGAGATATAACAGAGCA|CTATCACATGCATTCCGCCAGGACGGTATT
AGAGCACCGCGGAACGGAATGCAACAGTAC|CTGAGCGCTGAGCTACGATGGGCACGCGCC
TATAACAGAGCACCGCGGAACGGAATGCAA|CTGCAACTGAGCGCTGAGCTACGATGGGCA
GCGTAGCGCCAGTGCTCATATCCTGGGAGA|TCGTTACGTTTCCTATCACATGCATTCCGC
AGAGCACCGCGGAACGGGAGATATAACAGA|ATAAATGCTGGGCAAGCATGCGCGCAGCTG
TAAATGCTGGGCAAGCATGCGCGCAGCTGT|ACGGAATAAGGGGTACAAATTCTGAGGAGT
CCGCGGAACGGAATGTCGCCGTGGTCGTTA|CGATGCTCAGAAACTGGCACGTGTTGGCCC
TCGGTTCGAGTCTCTGTGTTATGAGCATTC|GTTGCATTACAGACGGGTTTATTGGTACAG
GCTGGTGCAGGCCGTACGGATCAAGTTGGC|GAACGGAATACCGCGGAACGGAATAGAGCA
CAGAGCACCGCGGAACGGAATGATTTTGTA|GAGATATAACAGAGCACCGCGGAACGGAAT
TAACAGAGCACCGCGGAACGGAATGAAGGG|TAACAGAGCGAGATATAACAGAGCACCGCG
TCCCAAGAATACAGTGGGCCCTATACCAAC|ATAAACGTCCAGATTTATGGCTTTAAGGTC
GACGGTATTTTTGAGATATAACAGAGCACC|TACGGATCAAGTTGGCCTACGTATAAATGC
GCAGCTGTGAACGATTGGATGGTCGGAGAT|TGAGGAGTTTATTCCATATGCGGAGATATA
CACCGCGGAACGGAATCCGCCTTAACTAAG|TTTTTGAGATATAACAGAGCACCGCGGAAC
TCCGATGCTCAGAAACTGGCACGTGTTGGC|TATAACAGAGCACCGCGGAACGGAATAATG
AAGGTCACTAGTCATCGGGGAGTACGGCCC|GCAGTGATTAATCCGGTCAATCTTTCTCCG
CACACTTTATTTCCGGGAGATATAACAGAG|GGGGAGTACGGCCCGCCATCCTGCAACTGA
AGATTGATACCAGTAACACGGAATAAACGT|AAAGTAGCTTGGACACACATGCTGTCTATG
ATTTTTGAGATATAACAGAGCACCGCGGAA|TCAAGTTGGCCTACGTATAAATGCTGGGCA
CAGTGCTCATATCCTGGGAGATATAACAGA|TTCCTATCACATGCATTCCGCCAGGACGGT
ACCGCGTGTTTCCGGTGAGATATAACAGAG|AGTGCTCATATCCTGGGAGATATAACAGAG
AATGATTTTGTATTCTTCATGGCTGGCACC|GCGGAACGGAATGTGTTAGAGAGCATGGAG
CCGCGGAACGGAATTCACTGGAGATATAAC|CCGCGGAACGGAATCCGCCTTAACTAAGGA
GTGTTTCCGGTGAGATATAACAGAGCACCG|TCATATCCTGGGAGATATAACAGAGCACCG
GTGTTATGAGCATTCTCTCTACGAGATATA|GGTTTATTGGTACAGAGATATAACAGAGCA
GAGCACCGCGGAACGGAATGCAACAGTACC|TGAGCGCTGAGCTACGATGGGCACGCGCCG
ATAAACGTCCAGATTTATGGCTTTAAGGTC|TGTCTATGTCATTCTGGGACAACTGCAGTG
ATAACAGAGCACCGCGGAACGGAATGATTT|GGGGGAGATATAACAGAGCACCGCGGAACG
GAGATATAACAGAGCACCGCGGAACGGAAT|ATGATTTTGTATTCTTCATGGCTGGCACCA
ACCTCTGAGGAAATCCATCCACAGTAGTTG|AAACGGGAGATTTGACGGTCCCAAGAATAC
CGGAATGAAGGGGCTGGTGCAGGCCGTACG|CAGAGCACCGCGGAACGGAATACCGCGGAA
GATTTTGTATTCTTCATGGCTGGCACCATG|GAACGGAATGTGTTAGAGAGCATGGAGGAT
GGAGATTTGACGGTCCCAAGAATACAGTGG|CCAGTAACACGGAATAAACGTCCAGATTTA
TAACAGAGCACCGCGGAACGGAATGATTTT|GGGGAGATATAACAGAGCACCGCGGAACGG
TTTGTTCACGTGTTATGGGGCGTGAGCAAA|GGAACGGAATGCAACAGTACCCACCGAGTA
TACAGTGGGCCCTATACCAACACTTCAGCT|CAGATTTATGGCTTTAAGGTCACTAGTCAT
GATCAGCGTCGGTTCGAGTCTCTGTGTTAT|CCACAGTAGTTGCATTACAGACGGGTTTAT
AATACCGCGGAACGGAATAGAGCACCGCGG|CCATGCCTGCTCAGGCCACCATTCTGCTAC
GGAACGGAATCCGCCTTAACTAAGGATCAG|AGATATAACAGAGCACCGCGGAACGGGAGA
TGGGCCCTATACCAACACTTCAGCTTCACA|TTATGGCTTTAAGGTCACTAGTCATCGGGG
CTGGCACCATGCCTGCTCAGGCCACCATTC|GCATGGAGGATTTACGGGAGATATAACAGA
GGAGTACGGCCCGCCATCCTGCAACTGAGC|AATCTTTCTCCGTTCTTGTTAAGGTCAGGG
GTCGTTACGTTTCCTATCACATGCATTCCG|CCGCGGAACGGAATGAAGGGGCTGGTGCAG
ACGGAATAACAAGTTGAGACAGTCTACTGA|GCGACCCCTTTGTTCACGTGTTATGGGGCG
GGAGATATAACAGAGCACCGCGGAACGGAA|TACTGACTGTGAACATATCCACCTCTGAGG
ATTGATACCAGTAACACGGAATAAACGTCC|AGTAGCTTGGACACACATGCTGTCTATGTC
TATAACGAGATATAACAGAGCGAGATATAA|AACAGAGCACCGCGGAACGGAATGATTTTG
GCTTCACACTTTATTTCCGGGAGATATAAC|CATCGGGGAGTACGGCCCGCCATCCTGCAA
CCGGTGAGATATAACAGAGCACCGCGGAAC|CCTGGGAGATATAACAGAGCACCGCGGAAC
AGCGAGATATAACAGAGCACCGCGGAACGG|GGAATGATTTTGTATTCTTCATGGCTGGCA
CGCGCAGCTGTGAACGATTGGATGGTCGGA|TTCTGAGGAGTTTATTCCATATGCGGAGAT
TCAGTCCGATGCTCAGAAACTGGCACGTGT|GAGATATAACAGAGCACCGCGGAACGGAAT
TCGTTACGTTTCCTATCACATGCATTCCGC|CGCGGAACGGAATGAAGGGGCTGGTGCAGG
GCTCATATCCTGGGAGATATAACAGAGCAC|TATCACATGCATTCCGCCAGGACGGTATTT
CAGTAGTTGCATTACAGACGGGTTTATTGG|CAAGAATACAGTGGGCCCTATACCAACACT
TTGGATGGTCGGAGATATAACGAGATATAA|CATATGCGGAGATATAACAGAGCACCGCGG
CATTCCGCCAGGACGGTATTTTTGAGATAT|GGTGCAGGCCGTACGGATCAAGTTGGCCTA
GGCCGTACGGATCAAGTTGGCCTACGTATA|ACCGCGGAACGGAATAGAGCACCGCGGAAC
CAGAGCACCGCGGAACGGAATACCGCGGAA|TATTCTTCATGGCTGGCACCATGCCTGCTC
TCATATCCTGGGAGATATAACAGAGCACCG|TCACATGCATTCCGCCAGGACGGTATTTTT
TGCTCAGAAACTGGCACGTGTTGGCCCTCT|CAGAGCACCGCGGAACGGAATAATGTCTAG
ACGGAATCGCGACCCCTTTGTTCACGTGTT|TATAACAGAGCACCGCGGAACGGAATGCAA
GAGCACCGCGGAACGGAATGAAGGGGCTGG|GAGCGAGATATAACAGAGCACCGCGGAACG
AGCACCGCGGAACGGAATAAGGGGTACAAA|ATTCTGCTACGGCCATGAGTCTATTCGGAT
GGAGATATAACAGAGCACCGCGGAACGGAA|CCATCCTGCAACTGAGCGCTGAGCTACGAT
GAATATGACACGATCAGCGTCGGTTCGAGT|AGGAAATCCATCCACAGTAGTTGCATTACA
GAGCACCGCGGAACGGAATAATGTCTAGGG|TGTGAACGATTGGATGGTCGGAGATATAAC
TCAATTAGGTGATGTAGGGGGAGATATAAC|AGTCTCTGTGTTATGAGCATTCTCTCTACG
CCGCGTGTTTCCGGTGAGATATAACAGAGC|GTGCTCATATCCTGGGAGATATAACAGAGC
GGCCACCATTCTGCTACGGCCATGAGTCTA|GATATAACAGAGCACCGCGGAACGGAATAT
TAACAGAGCACCGCGGAACGGAATGTGTTA|TACGAGATATAACAGAGCACCGCGGAACGG
GCACGTGTTGGCCCTCTCTTTTGATACGAC|AACGGAATAATGTCTAGGGGAGATATAACA
TTCATGGCTGGCACCATGCCTGCTCAGGCC|TTAGAGAGCATGGAGGATTTACGGGAGATA
TGCCTGCTCAGGCCACCATTCTGCTACGGC|ATTTACGGGAGATATAACAGAGCACCGCGG
TCTGTGTTATGAGCATTCTCTCTACGAGAT|ACGGGTTTATTGGTACAGAGATATAACAGA
CCTTAACTAAGGATCAGTCCGATGCTCAGA|CACCGCGGAACGGGAGATATAACAGAGCAC
AACAAGTTGAGACAGTCTACTGACTGTGAA|CTTTGTTCACGTGTTATGGGGCGTGAGCAA
CGTATAAATGCTGGGCAAGCATGCGCGCAG|CGGAACGGAATAAGGGGTACAAATTCTGAG
CGTGTTATGGGGCGTGAGCAAAACAAGGAA|ATGCAACAGTACCCACCGAGTATTAGATTG
CTGGAGATATAACAGAGCACCGCGGAACGG|CCTTAACTAAGGATCAGTCCGATGCTCAGA
CCTATCACATGCATTCCGCCAGGACGGTAT|ATGAAGGGGCTGGTGCAGGCCGTACGGATC
GGGGTACAAATTCTGAGGAGTTTATTCCAT|CTATTCGGATTGACGCAAGTGAAATCAATT
TAGGGGAGATATAACAGAGCACCGCGGAAC|ATAACGAGATATAACAGAGCGAGATATAAC
CATGGCTGGCACCATGCCTGCTCAGGCCAC|AGAGAGCATGGAGGATTTACGGGAGATATA
AGTACGGCCCGCCATCCTGCAACTGAGCGC|TCTTTCTCCGTTCTTGTTAAGGTCAGGGCG
AGATATAACAGAGCACCGCGGAACGGAATC|TTCACACTTTATTTCCGGGAGATATAACAG
ACGTGTTGGCCCTCTCTTTTGATACGACTT|CGGAATAATGTCTAGGGGAGATATAACAGA
GGAATAATGTCTAGGGGAGATATAACAGAG|TGGTCGGAGATATAACGAGATATAACAGAG
CACCGCGGAACGGAATAACAAGTTGAGACA|AACGGAATCGCGACCCCTTTGTTCACGTGT
GAACGGAATCGCGACCCCTTTGTTCACGTG|GATATAACAGAGCACCGCGGAACGGAATGC
GGAACGGAATGATTTTGTATTCTTCATGGC|GAGCACCGCGGAACGGAATGTGTTAGAGAG
TAGTTGCATTACAGACGGGTTTATTGGTAC|GAATACAGTGGGCCCTATACCAACACTTCA
TGTGTTATGAGCATTCTCTCTACGAGATAT|GGGTTTATTGGTACAGAGATATAACAGAGC
TGTATTCTTCATGGCTGGCACCATGCCTGC|GAATGTGTTAGAGAGCATGGAGGATTTACG
GGCTTTAAGGTCACTAGTCATCGGGGAGTA|ACAACTGCAGTGATTAATCCGGTCAATCTT
AAACGGGAGATTTGACGGTCCCAAGAATAC|TGATACCAGTAACACGGAATAAACGTCCAG
TTGTTCACGTGTTATGGGGCGTGAGCAAAA|GAACGGAATGCAACAGTACCCACCGAGTAT
AATAACAAGTTGAGACAGTCTACTGACTGT|CCCCTTTGTTCACGTGTTATGGGGCGTGAG
AGAGCACCGCGGAACGGAATCGCGACCCCT|TATTTCCGGGAGATATAACAGAGCACCGCG
TTTAAGGTCACTAGTCATCGGGGAGTACGG|ACTGCAGTGATTAATCCGGTCAATCTTTCT
CATATCCTGGGAGATATAACAGAGCACCGC|CACATGCATTCCGCCAGGACGGTATTTTTG
TATAACAGAGCACCGCGGAACGGAATAACA|AGCACCGCGGAACGGAATCGCGACCCCTTT
TATGAGCATTCTCTCTACGAGATATAACAG|TATTGGTACAGAGATATAACAGAGCACCGC
CGTCCAGATTTATGGCTTTAAGGTCACTAG|ATGTCATTCTGGGACAACTGCAGTGATTAA
CGGAACGGAATAGAGCACCGCGGAACGGAA|TGCTCAGGCCACCATTCTGCTACGGCCATG
AGAGCGAGATATAACAGAGCACCGCGGAAC|ACGGAATGATTTTGTATTCTTCATGGCTGG
AGTTGAGACAGTCTACTGACTGTGAACATA|GTTCACGTGTTATGGGGCGTGAGCAAAACA
GATGTAGGGGGAGATATAACAGAGCACCGC|TTATGAGCATTCTCTCTACGAGATATAACA
CAGAGCACCGCGGAACGGAATCCGCCTTAA|CGGTATTTTTGAGATATAACAGAGCACCGC
GTGCTCATATCCTGGGAGATATAACAGAGC|CCTATCACATGCATTCCGCCAGGACGGTAT
TTATGGGGCGTGAGCAAAACAAGGAAACGG|AACAGTACCCACCGAGTATTAGATTGATAC
GTGGGCCCTATACCAACACTTCAGCTTCAC|TTTATGGCTTTAAGGTCACTAGTCATCGGG
GTTTCCGGTGAGATATAACAGAGCACCGCG|ATATCCTGGGAGATATAACAGAGCACCGCG
CTATTCGGATTGACGCAAGTGAAATCAATT|TATGACACGATCAGCGTCGGTTCGAGTCTC
GGTGCACCGCGTGTTTCCGGTGAGATATAA|GCGCCAGTGCTCATATCCTGGGAGATATAA
ATACCGCGGAACGGAATAGAGCACCGCGGA|CATGCCTGCTCAGGCCACCATTCTGCTACG
GATATAACAGAGCACCGCGGAACGGAATTC|GATATAACAGAGCACCGCGGAACGGAATCC
AACATAGCGTAGCGCCAGTGCTCATATCCT|TTAGAGTCGTTACGTTTCCTATCACATGCA
ATATAACAGAGCACCGCGGAACGGAATAAC|GAGCACCGCGGAACGGAATCGCGACCCCTT
GTACGGATCAAGTTGGCCTACGTATAAATG|CGGAACGGAATAGAGCACCGCGGAACGGAA
ACAGACGGGTTTATTGGTACAGAGATATAA|GGCCCTATACCAACACTTCAGCTTCACACT
CCGATGCTCAGAAACTGGCACGTGTTGGCC|ATAACAGAGCACCGCGGAACGGAATAATGT
GCATGCGCGCAGCTGTGAACGATTGGATGG|ACAAATTCTGAGGAGTTTATTCCATATGCG
TATAACATAGCGTAGCGCCAGTGCTCATAT|GACTTAGAGTCGTTACGTTTCCTATCACAT
GCAAGCATGCGCGCAGCTGTGAACGATTGG|GGGTACAAATTCTGAGGAGTTTATTCCATA
CCAGATTTATGGCTTTAAGGTCACTAGTCA|TCATTCTGGGACAACTGCAGTGATTAATCC
GCTGCGCTATAACATAGCGTAGCGCCAGTG|TTGATACGACTTAGAGTCGTTACGTTTCCT
GAGCATGGAGGATTTACGGGAGATATAACA|TAACAAGTTGAGACAGTCTACTGACTGTGA
GTTTATTCCATATGCGGAGATATAACAGAG|TGAAATCAATTAGGTGATGTAGGGGGAGAT
TCCGGTGAGATATAACAGAGCACCGCGGAA|TCCTGGGAGATATAACAGAGCACCGCGGAA
ACGTCCAGATTTATGGCTTTAAGGTCACTA|TATGTCATTCTGGGACAACTGCAGTGATTA
CAGACGGGTTTATTGGTACAGAGATATAAC|GCCCTATACCAACACTTCAGCTTCACACTT
AACAGAGCGAGATATAACAGAGCACCGCGG|GGAACGGAATGATTTTGTATTCTTCATGGC
GCTGGCACCATGCCTGCTCAGGCCACCATT|AGCATGGAGGATTTACGGGAGATATAACAG
AGTCATCGGGGAGTACGGCCCGCCATCCTG|AATCCGGTCAATCTTTCTCCGTTCTTGTTA
GGAATCCGCCTTAACTAAGGATCAGTCCGA|TAACAGAGCACCGCGGAACGGGAGATATAA
CACCGCGGAACGGAATAATGTCTAGGGGAG|GAACGATTGGATGGTCGGAGATATAACGAG
ACAGAGCACCGCGGAACGGAATGTGTTAGA|CGAGATATAACAGAGCACCGCGGAACGGAA
TTCGAGTCTCTGTGTTATGAGCATTCTCTC|CATTACAGACGGGTTTATTGGTACAGAGAT
AGGGGCTGGTGCAGGCCGTACGGATCAAGT|CGCGGAACGGAATACCGCGGAACGGAATAG
CGGAGATATAACAGAGCACCGCGGAACGGA|TGATGTAGGGGGAGATATAACAGAGCACCG
GCTCAGGCCACCATTCTGCTACGGCCATGA|CGGGAGATATAACAGAGCACCGCGGAACGG
TTCACACTTTATTTCCGGGAGATATAACAG|TCGGGGAGTACGGCCCGCCATCCTGCAACT
GAAATCCATCCACAGTAGTTGCATTACAGA|ATTTGACGGTCCCAAGAATACAGTGGGCCC
CAGAGCACCGCGGAACGGAATAATGTCTAG|GCTGTGAACGATTGGATGGTCGGAGATATA
GAGATTTGACGGTCCCAAGAATACAGTGGG|CAGTAACACGGAATAAACGTCCAGATTTAT
TCTCTCTACGAGATATAACAGAGCACCGCG|AGAGATATAACAGAGCACCGCGGAACGGAA
AGCACCGCGGAACGGAATGAAGGGGCTGGT|AGCGAGATATAACAGAGCACCGCGGAACGG
TATCCACCTCTGAGGAAATCCATCCACAGT|CAAGGAAACGGGAGATTTGACGGTCCCAAG
TGGAGATATAACAGAGCACCGCGGAACGGA|CTTAACTAAGGATCAGTCCGATGCTCAGAA
ATAACAGAGCACCGCGGAACGGAATGCAAC|TGCAACTGAGCGCTGAGCTACGATGGGCAC
ATGTTAGGTGCACCGCGTGTTTCCGGTGAG|AGCGTAGCGCCAGTGCTCATATCCTGGGAG
GGTCGTTAGTCCAAGCTGCGCTATAACATA|GTTGGCCCTCTCTTTTGATACGACTTAGAG
GAATGTGTTAGAGAGCATGGAGGATTTACG|CGCGGAACGGAATAACAAGTTGAGACAGTC
ACACGGAATAAACGTCCAGATTTATGGCTT|CACATGCTGTCTATGTCATTCTGGGACAAC
CCTGCTCAGGCCACCATTCTGCTACGGCCA|TTACGGGAGATATAACAGAGCACCGCGGAA
CCTCTCTTTTGATACGACTTAGAGTCGTTA|TCTAGGGGAGATATAACAGAGCACCGCGGA
CGCGGAACGGGAGATATAACAGAGCACCGC|CTGGGCAAGCATGCGCGCAGCTGTGAACGA
ATCACATGCATTCCGCCAGGACGGTATTTT|AAGGGGCTGGTGCAGGCCGTACGGATCAAG
TTTCCGGGAGATATAACAGAGCACCGCGGA|GGCCCGCCATCCTGCAACTGAGCGCTGAGC
CGCTATAACATAGCGTAGCGCCAGTGCTCA|TACGACTTAGAGTCGTTACGTTTCCTATCA
ATAACAGAGCACCGCGGAACGGGAGATATA|TACGTATAAATGCTGGGCAAGCATGCGCGC
AGAGCACCGCGGAACGGAATAATGTCTAGG|CTGTGAACGATTGGATGGTCGGAGATATAA
GAACGGAATTCACTGGAGATATAACAGAGC|GAACGGAATCCGCCTTAACTAAGGATCAGT
TCCATCCACAGTAGTTGCATTACAGACGGG|GACGGTCCCAAGAATACAGTGGGCCCTATA
CTTCACACTTTATTTCCGGGAGATATAACA|ATCGGGGAGTACGGCCCGCCATCCTGCAAC
AGATATAACGAGATATAACAGAGCGAGATA|TATAACAGAGCACCGCGGAACGGAATGATT
AAGTGAAATCAATTAGGTGATGTAGGGGGA|TCGGTTCGAGTCTCTGTGTTATGAGCATTC
GGAACGGAATAAGGGGTACAAATTCTGAGG|ACGGCCATGAGTCTATTCGGATTGACGCAA
AACAGAGCACCGCGGAACGGAATAACAAGT|ACCGCGGAACGGAATCGCGACCCCTTTGTT
GGTCGGAGATATAACGAGATATAACAGAGC|CGGAGATATAACAGAGCACCGCGGAACGGA
TACGGATCAAGTTGGCCTACGTATAAATGC|GGAACGGAATAGAGCACCGCGGAACGGAAT
GAAACGGGAGATTTGACGGTCCCAAGAATA|TTGATACCAGTAACACGGAATAAACGTCCA
ATAACAGAGCACCGCGGAACGGAATAACAA|GCACCGCGGAACGGAATCGCGACCCCTTTG
TATAAATGCTGGGCAAGCATGCGCGCAGCT|GAACGGAATAAGGGGTACAAATTCTGAGGA
AGAGCACCGCGGAACGGAATGTCGCCGTGG|TCAGTCCGATGCTCAGAAACTGGCACGTGT
CGCCAGTGCTCATATCCTGGGAGATATAAC|CGTTTCCTATCACATGCATTCCGCCAGGAC
AGCATGGAGGATTTACGGGAGATATAACAG|AACAAGTTGAGACAGTCTACTGACTGTGAA
CGTGAGCAAAACAAGGAAACGGGAGATTTG|CCACCGAGTATTAGATTGATACCAGTAACA
CACTAGTCATCGGGGAGTACGGCCCGCCAT|GATTAATCCGGTCAATCTTTCTCCGTTCTT
TATGACACGATCAGCGTCGGTTCGAGTCTC|AAATCCATCCACAGTAGTTGCATTACAGAC
CGGGAGATATAACAGAGCACCGCGGAACGG|AGCATGCGCGCAGCTGTGAACGATTGGATG
CGGAACGGAATAATGTCTAGGGGAGATATA|ATTGGATGGTCGGAGATATAACGAGATATA
ACGGAATAAACGTCCAGATTTATGGCTTTA|CATGCTGTCTATGTCATTCTGGGACAACTG
TGCGGAGATATAACAGAGCACCGCGGAACG|GGTGATGTAGGGGGAGATATAACAGAGCAC
AAGAATACAGTGGGCCCTATACCAACACTT|ACGTCCAGATTTATGGCTTTAAGGTCACTA
GATATAACAGAGCACCGCGGAACGGAATGA|GATATAACAGAGCGAGATATAACAGAGCAC
CTGGTGCAGGCCGTACGGATCAAGTTGGCC|AACGGAATACCGCGGAACGGAATAGAGCAC
GAGCACCGCGGAACGGAATTCACTGGAGAT|GAGCACCGCGGAACGGAATCCGCCTTAACT
AGTTTATTCCATATGCGGAGATATAACAGA|GTGAAATCAATTAGGTGATGTAGGGGGAGA
ACCGCGGAACGGAATGCAACAGTACCCACC|CGCTGAGCTACGATGGGCACGCGCCGGCCT
AGATATAACAGAGCACCGCGGAACGGAATG|TGTAGGGGGAGATATAACAGAGCACCGCGG
GCAGGCCGTACGGATCAAGTTGGCCTACGT|AATACCGCGGAACGGAATAGAGCACCGCGG
CGATTGGATGGTCGGAGATATAACGAGATA|TTCCATATGCGGAGATATAACAGAGCACCG
CATAGCGTAGCGCCAGTGCTCATATCCTGG|AGAGTCGTTACGTTTCCTATCACATGCATT
AACGGAATAGAGCACCGCGGAACGGAATAA|TCAGGCCACCATTCTGCTACGGCCATGAGT
GGCCCTCTCTTTTGATACGACTTAGAGTCG|ATGTCTAGGGGAGATATAACAGAGCACCGC
AGTGGGCCCTATACCAACACTTCAGCTTCA|ATTTATGGCTTTAAGGTCACTAGTCATCGG
ACGATTGGATGGTCGGAGATATAACGAGAT|ATTCCATATGCGGAGATATAACAGAGCACC
TTCACTGGAGATATAACAGAGCACCGCGGA|TCCGCCTTAACTAAGGATCAGTCCGATGCT
TGGTCGTTAGTCCAAGCTGCGCTATAACAT|TGTTGGCCCTCTCTTTTGATACGACTTAGA
CAGAGCACCGCGGAACGGAATGCAACAGTA|ACTGAGCGCTGAGCTACGATGGGCACGCGC
TACCGCGGAACGGAATAGAGCACCGCGGAA|ATGCCTGCTCAGGCCACCATTCTGCTACGG
ATTCACTGGAGATATAACAGAGCACCGCGG|ATCCGCCTTAACTAAGGATCAGTCCGATGC
GAGATATAACAGAGCACCGCGGAACGGAAT|GAGATATAACAGAGCGAGATATAACAGAGC
TCTTTTGATACGACTTAGAGTCGTTACGTT|GGGGAGATATAACAGAGCACCGCGGAACGG
AACGGAATTCACTGGAGATATAACAGAGCA|AACGGAATCCGCCTTAACTAAGGATCAGTC
AGATATAACAGAGCACCGCGGAACGGAATT|AGATATAACAGAGCACCGCGGAACGGAATC
CACCGCGGAACGGAATAAGGGGTACAAATT|TCTGCTACGGCCATGAGTCTATTCGGATTG
AATTCTGAGGAGTTTATTCCATATGCGGAG|ATTGACGCAAGTGAAATCAATTAGGTGATG
GCACCGCGGAACGGAATACCGCGGAACGGA|CTTCATGGCTGGCACCATGCCTGCTCAGGC
GAGCACCGCGGAACGGAATATGACACGATC|ACATATCCACCTCTGAGGAAATCCATCCAC
TTTGATACGACTTAGAGTCGTTACGTTTCC|GAGATATAACAGAGCACCGCGGAACGGAAT
TAGTCATCGGGGAGTACGGCCCGCCATCCT|TAATCCGGTCAATCTTTCTCCGTTCTTGTT
CAACACTTCAGCTTCACACTTTATTTCCGG|GGTCACTAGTCATCGGGGAGTACGGCCCGC
GGAATAAGGGGTACAAATTCTGAGGAGTTT|CATGAGTCTATTCGGATTGACGCAAGTGAA
CCAGTGCTCATATCCTGGGAGATATAACAG|TTTCCTATCACATGCATTCCGCCAGGACGG
GGACGGTATTTTTGAGATATAACAGAGCAC|GTACGGATCAAGTTGGCCTACGTATAAATG
CTAAGGATCAGTCCGATGCTCAGAAACTGG|GGAACGGGAGATATAACAGAGCACCGCGGA
CCTACGTATAAATGCTGGGCAAGCATGCGC|ACCGCGGAACGGAATAAGGGGTACAAATTC
GCCTACGTATAAATGCTGGGCAAGCATGCG|CACCGCGGAACGGAATAAGGGGTACAAATT
CAAGTTGGCCTACGTATAAATGCTGGGCAA|AATAGAGCACCGCGGAACGGAATAAGGGGT
GAGCACCGCGGAACGGAATCGCGACCCCTT|ATTTCCGGGAGATATAACAGAGCACCGCGG
AAATCCATCCACAGTAGTTGCATTACAGAC|TTTGACGGTCCCAAGAATACAGTGGGCCCT
TGAGCATTCTCTCTACGAGATATAACAGAG|TTGGTACAGAGATATAACAGAGCACCGCGG
ACCGAGTATTAGATTGATACCAGTAACACG|CCTTGTACGAAAAGTAGCTTGGACACACAT
GGGAGTACGGCCCGCCATCCTGCAACTGAG|CAATCTTTCTCCGTTCTTGTTAAGGTCAGG
GCGGAACGGAATGTCGCCGTGGTCGTTAGT|ATGCTCAGAAACTGGCACGTGTTGGCCCTC
AGTCCAAGCTGCGCTATAACATAGCGTAGC|CTCTCTTTTGATACGACTTAGAGTCGTTAC
GGGGCGTGAGCAAAACAAGGAAACGGGAGA|GTACCCACCGAGTATTAGATTGATACCAGT
ATGCAACAGTACCCACCGAGTATTAGATTG|TGGGCACGCGCCGGCCTTGTACGAAAAGTA
AGAGCACCGCGGAACGGAATGATTTTGTAT|AGATATAACAGAGCACCGCGGAACGGAATG
ACGGAATGCAACAGTACCCACCGAGTATTA|TACGATGGGCACGCGCCGGCCTTGTACGAA
AAACGTCCAGATTTATGGCTTTAAGGTCAC|TCTATGTCATTCTGGGACAACTGCAGTGAT
ATACCAACACTTCAGCTTCACACTTTATTT|TTAAGGTCACTAGTCATCGGGGAGTACGGC
ATGCATTCCGCCAGGACGGTATTTTTGAGA|GCTGGTGCAGGCCGTACGGATCAAGTTGGC
GAACGGAATGCAACAGTACCCACCGAGTAT|GCTACGATGGGCACGCGCCGGCCTTGTACG
ACAGAGCACCGCGGAACGGAATCGCGACCC|TTTATTTCCGGGAGATATAACAGAGCACCG
ATATGACACGATCAGCGTCGGTTCGAGTCT|GAAATCCATCCACAGTAGTTGCATTACAGA
ACCATTCTGCTACGGCCATGAGTCTATTCG|TAACAGAGCACCGCGGAACGGAATATGACA
GTGGTCGTTAGTCCAAGCTGCGCTATAACA|GTGTTGGCCCTCTCTTTTGATACGACTTAG
TGAGATATAACAGAGCACCGCGGAACGGAA|GGAGATATAACAGAGCACCGCGGAACGGAA
CCGTGGTCGTTAGTCCAAGCTGCGCTATAA|ACGTGTTGGCCCTCTCTTTTGATACGACTT
CGAGATATAACAGAGCACCGCGGAACGGAA|AACAGAGCACCGCGGAACGGAATCGCGACC
AGATTTATGGCTTTAAGGTCACTAGTCATC|ATTCTGGGACAACTGCAGTGATTAATCCGG
CGGTATTTTTGAGATATAACAGAGCACCGC|CGGATCAAGTTGGCCTACGTATAAATGCTG
CTGAGGAAATCCATCCACAGTAGTTGCATT|GGGAGATTTGACGGTCCCAAGAATACAGTG
TAAGGATCAGTCCGATGCTCAGAAACTGGC|GAACGGGAGATATAACAGAGCACCGCGGAA
GTCCCAAGAATACAGTGGGCCCTATACCAA|AATAAACGTCCAGATTTATGGCTTTAAGGT
TACAAATTCTGAGGAGTTTATTCCATATGC|TCGGATTGACGCAAGTGAAATCAATTAGGT
TCTCTTTTGATACGACTTAGAGTCGTTACG|TAGGGGAGATATAACAGAGCACCGCGGAAC
TGTAGGGGGAGATATAACAGAGCACCGCGG|ATGAGCATTCTCTCTACGAGATATAACAGA
TCGCCGTGGTCGTTAGTCCAAGCTGCGCTA|GGCACGTGTTGGCCCTCTCTTTTGATACGA
ACCGCGGAACGGGAGATATAACAGAGCACC|TGCTGGGCAAGCATGCGCGCAGCTGTGAAC
CACTTTATTTCCGGGAGATATAACAGAGCA|GGAGTACGGCCCGCCATCCTGCAACTGAGC
TGAGATATAACAGAGCACCGCGGAACGGGA|TTGGCCTACGTATAAATGCTGGGCAAGCAT
TATTCCATATGCGGAGATATAACAGAGCAC|AATCAATTAGGTGATGTAGGGGGAGATATA
ATAGAGCACCGCGGAACGGAATAAGGGGTA|CACCATTCTGCTACGGCCATGAGTCTATTC
TTGCATTACAGACGGGTTTATTGGTACAGA|TACAGTGGGCCCTATACCAACACTTCAGCT
TTAGAGTCGTTACGTTTCCTATCACATGCA|GAGCACCGCGGAACGGAATGAAGGGGCTGG
GTCCGATGCTCAGAAACTGGCACGTGTTGG|ATATAACAGAGCACCGCGGAACGGAATAAT
GGAATAACAAGTTGAGACAGTCTACTGACT|GACCCCTTTGTTCACGTGTTATGGGGCGTG
TATAACAGAGCACCGCGGAACGGAATGTCG|TAAGGATCAGTCCGATGCTCAGAAACTGGC
AGGACGGTATTTTTGAGATATAACAGAGCA|CGTACGGATCAAGTTGGCCTACGTATAAAT
ACTGTGAACATATCCACCTCTGAGGAAATC|GTGAGCAAAACAAGGAAACGGGAGATTTGA
TACGGCCATGAGTCTATTCGGATTGACGCA|CCGCGGAACGGAATATGACACGATCAGCGT
AGTGCTCATATCCTGGGAGATATAACAGAG|TCCTATCACATGCATTCCGCCAGGACGGTA
ACCGCGGAACGGAATCGCGACCCCTTTGTT|CCGGGAGATATAACAGAGCACCGCGGAACG
GGTACAGAGATATAACAGAGCACCGCGGAA|CTTCAGCTTCACACTTTATTTCCGGGAGAT
TCTACTGACTGTGAACATATCCACCTCTGA|ATGGGGCGTGAGCAAAACAAGGAAACGGGA
GGGAGATATAACAGAGCACCGCGGAACGGA|TTCCGCCAGGACGGTATTTTTGAGATATAA
GAGCACCGCGGAACGGAATGTGTTAGAGAG|GATATAACAGAGCACCGCGGAACGGAATAA
AACAGAGCACCGCGGAACGGAATTCACTGG|AACAGAGCACCGCGGAACGGAATCCGCCTT
GGGGAGTACGGCCCGCCATCCTGCAACTGA|TCAATCTTTCTCCGTTCTTGTTAAGGTCAG
GCGGAACGGAATAATGTCTAGGGGAGATAT|GATTGGATGGTCGGAGATATAACGAGATAT
GAGATATAACAGAGCACCGCGGAACGGAAT|ACAGAGCACCGCGGAACGGAATCGCGACCC
GGAACGGAATATGACACGATCAGCGTCGGT|CCTCTGAGGAAATCCATCCACAGTAGTTGC
GAGCGAGATATAACAGAGCACCGCGGAACG|CGGAATGATTTTGTATTCTTCATGGCTGGC
ATAACAAGTTGAGACAGTCTACTGACTGTG|CCCTTTGTTCACGTGTTATGGGGCGTGAGC
TTGGTACAGAGATATAACAGAGCACCGCGG|CACTTCAGCTTCACACTTTATTTCCGGGAG
CACCATGCCTGCTCAGGCCACCATTCTGCT|GGAGGATTTACGGGAGATATAACAGAGCAC
GTCGCCGTGGTCGTTAGTCCAAGCTGCGCT|TGGCACGTGTTGGCCCTCTCTTTTGATACG
GACAGTCTACTGACTGTGAACATATCCACC|GTGTTATGGGGCGTGAGCAAAACAAGGAAA
TATAACAGAGCACCGCGGAACGGAATGATT|AGGGGGAGATATAACAGAGCACCGCGGAAC
GAACGGAATGTCGCCGTGGTCGTTAGTCCA|CTCAGAAACTGGCACGTGTTGGCCCTCTCT
CATCGGGGAGTACGGCCCGCCATCCTGCAA|CCGGTCAATCTTTCTCCGTTCTTGTTAAGG
TCGAGTCTCTGTGTTATGAGCATTCTCTCT|ATTACAGACGGGTTTATTGGTACAGAGATA
AGAGCATGGAGGATTTACGGGAGATATAAC|ATAACAAGTTGAGACAGTCTACTGACTGTG
GCCAGTGCTCATATCCTGGGAGATATAACA|GTTTCCTATCACATGCATTCCGCCAGGACG
ACCGCGGAACGGAATGTGTTAGAGAGCATG|TAACAGAGCACCGCGGAACGGAATAACAAG
GATTGATACCAGTAACACGGAATAAACGTC|AAGTAGCTTGGACACACATGCTGTCTATGT
AACAGAGCACCGCGGAACGGAATGTCGCCG|GGATCAGTCCGATGCTCAGAAACTGGCACG
GCCACCATTCTGCTACGGCCATGAGTCTAT|ATATAACAGAGCACCGCGGAACGGAATATG
TGACGCAAGTGAAATCAATTAGGTGATGTA|TCAGCGTCGGTTCGAGTCTCTGTGTTATGA
ACGGAATCCGCCTTAACTAAGGATCAGTCC|TATAACAGAGCACCGCGGAACGGGAGATAT
GGGTACAAATTCTGAGGAGTTTATTCCATA|TATTCGGATTGACGCAAGTGAAATCAATTA
GAACGGAATAATGTCTAGGGGAGATATAAC|TGGATGGTCGGAGATATAACGAGATATAAC
GAGTATTAGATTGATACCAGTAACACGGAA|TGTACGAAAAGTAGCTTGGACACACATGCT
CAGTCCGATGCTCAGAAACTGGCACGTGTT|AGATATAACAGAGCACCGCGGAACGGAATA
GGAATATGACACGATCAGCGTCGGTTCGAG|GAGGAAATCCATCCACAGTAGTTGCATTAC
CCGCGGAACGGAATACCGCGGAACGGAATA|CATGGCTGGCACCATGCCTGCTCAGGCCAC
GCACCGCGGAACGGAATGTGTTAGAGAGCA|TATAACAGAGCACCGCGGAACGGAATAACA
AATACAGTGGGCCCTATACCAACACTTCAG|TCCAGATTTATGGCTTTAAGGTCACTAGTC
ATGATTTTGTATTCTTCATGGCTGGCACCA|CGGAACGGAATGTGTTAGAGAGCATGGAGG
GAGATATAACAGAGCACCGCGGAACGGAAT|ATGTAGGGGGAGATATAACAGAGCACCGCG
CAGAGCACCGCGGAACGGAATGTCGCCGTG|ATCAGTCCGATGCTCAGAAACTGGCACGTG
CGGAATAAGGGGTACAAATTCTGAGGAGTT|CCATGAGTCTATTCGGATTGACGCAAGTGA
AGCGTAGCGCCAGTGCTCATATCCTGGGAG|GTCGTTACGTTTCCTATCACATGCATTCCG
TCAGAAACTGGCACGTGTTGGCCCTCTCTT|AGCACCGCGGAACGGAATAATGTCTAGGGG
CGGGAGATATAACAGAGCACCGCGGAACGG|TCTACTGACTGTGAACATATCCACCTCTGA
ACGGAATAATGTCTAGGGGAGATATAACAG|GATGGTCGGAGATATAACGAGATATAACAG
GGAGGATTTACGGGAGATATAACAGAGCAC|GTTGAGACAGTCTACTGACTGTGAACATAT
GGTTCGAGTCTCTGTGTTATGAGCATTCTC|TGCATTACAGACGGGTTTATTGGTACAGAG
TAACAGAGCACCGCGGAACGGAATACCGCG|TTGTATTCTTCATGGCTGGCACCATGCCTG
TAACGAGATATAACAGAGCGAGATATAACA|CAGAGCACCGCGGAACGGAATGATTTTGTA
CGGAATGCAACAGTACCCACCGAGTATTAG|ACGATGGGCACGCGCCGGCCTTGTACGAAA
TGAGCAAAACAAGGAAACGGGAGATTTGAC|ACCGAGTATTAGATTGATACCAGTAACACG
GCACCGCGGAACGGAATAACAAGTTGAGAC|GAACGGAATCGCGACCCCTTTGTTCACGTG
ATGAGTCTATTCGGATTGACGCAAGTGAAA|ACGGAATATGACACGATCAGCGTCGGTTCG
AAAACAAGGAAACGGGAGATTTGACGGTCC|GTATTAGATTGATACCAGTAACACGGAATA
GAGATATAACAGAGCACCGCGGAACGGAAT|ATGCGCGCAGCTGTGAACGATTGGATGGTC
ATACAGTGGGCCCTATACCAACACTTCAGC|CCAGATTTATGGCTTTAAGGTCACTAGTCA
ACGAGATATAACAGAGCGAGATATAACAGA|GAGCACCGCGGAACGGAATGATTTTGTATT
ACCGCGGAACGGAATGATTTTGTATTCTTC|TAACAGAGCACCGCGGAACGGAATGTGTTA
ATGGCTGGCACCATGCCTGCTCAGGCCACC|GAGAGCATGGAGGATTTACGGGAGATATAA
GTGCAGGCCGTACGGATCAAGTTGGCCTAC|GGAATACCGCGGAACGGAATAGAGCACCGC
GAGCACCGCGGAACGGAATGTCGCCGTGGT|CAGTCCGATGCTCAGAAACTGGCACGTGTT
AGGGGAGATATAACAGAGCACCGCGGAACG|TAACGAGATATAACAGAGCGAGATATAACA
CGTAGCGCCAGTGCTCATATCCTGGGAGAT|CGTTACGTTTCCTATCACATGCATTCCGCC
AACAGAGCACCGCGGAACGGAATGCAACAG|CAACTGAGCGCTGAGCTACGATGGGCACGC
GCATTCTCTCTACGAGATATAACAGAGCAC|GTACAGAGATATAACAGAGCACCGCGGAAC
AGAGCACCGCGGAACGGAATGTGTTAGAGA|AGATATAACAGAGCACCGCGGAACGGAATA
TGGCTGGCACCATGCCTGCTCAGGCCACCA|AGAGCATGGAGGATTTACGGGAGATATAAC
CGGAACGGAATGATTTTGTATTCTTCATGG|AGAGCACCGCGGAACGGAATGTGTTAGAGA
TAGAGTCGTTACGTTTCCTATCACATGCAT|AGCACCGCGGAACGGAATGAAGGGGCTGGT
TGAGACAGTCTACTGACTGTGAACATATCC|CACGTGTTATGGGGCGTGAGCAAAACAAGG
TATGGGGCGTGAGCAAAACAAGGAAACGGG|ACAGTACCCACCGAGTATTAGATTGATACC
GGAATTCACTGGAGATATAACAGAGCACCG|GGAATCCGCCTTAACTAAGGATCAGTCCGA
ACTAAGGATCAGTCCGATGCTCAGAAACTG|CGGAACGGGAGATATAACAGAGCACCGCGG
ACACGATCAGCGTCGGTTCGAGTCTCTGTG|CCATCCACAGTAGTTGCATTACAGACGGGT
ATATAACAGAGCACCGCGGAACGGAATGCA|CCTGCAACTGAGCGCTGAGCTACGATGGGC
AATCAATTAGGTGATGTAGGGGGAGATATA|CGAGTCTCTGTGTTATGAGCATTCTCTCTA
GCAAAACAAGGAAACGGGAGATTTGACGGT|GAGTATTAGATTGATACCAGTAACACGGAA
AACGGAATGAAGGGGCTGGTGCAGGCCGTA|AACAGAGCACCGCGGAACGGAATACCGCGG
TTTATTCCATATGCGGAGATATAACAGAGC|GAAATCAATTAGGTGATGTAGGGGGAGATA
TGATGTAGGGGGAGATATAACAGAGCACCG|GTTATGAGCATTCTCTCTACGAGATATAAC
GACACGATCAGCGTCGGTTCGAGTCTCTGT|TCCATCCACAGTAGTTGCATTACAGACGGG
GCGGAACGGAATGATTTTGTATTCTTCATG|CAGAGCACCGCGGAACGGAATGTGTTAGAG
CATTCTGCTACGGCCATGAGTCTATTCGGA|ACAGAGCACCGCGGAACGGAATATGACACG
CTGTGAACGATTGGATGGTCGGAGATATAA|GAGTTTATTCCATATGCGGAGATATAACAG
CACCTCTGAGGAAATCCATCCACAGTAGTT|GAAACGGGAGATTTGACGGTCCCAAGAATA
CAGAGCACCGCGGAACGGAATAACAAGTTG|CGCGGAACGGAATCGCGACCCCTTTGTTCA
AACAGAGCACCGCGGAACGGAATGATTTTG|GGGAGATATAACAGAGCACCGCGGAACGGA
CAAGCATGCGCGCAGCTGTGAACGATTGGA|GGTACAAATTCTGAGGAGTTTATTCCATAT
CCATGAGTCTATTCGGATTGACGCAAGTGA|GAACGGAATATGACACGATCAGCGTCGGTT
CGCCTTAACTAAGGATCAGTCCGATGCTCA|AGCACCGCGGAACGGGAGATATAACAGAGC
GAACGGGAGATATAACAGAGCACCGCGGAA|GCAAGCATGCGCGCAGCTGTGAACGATTGG
CTACTGACTGTGAACATATCCACCTCTGAG|TGGGGCGTGAGCAAAACAAGGAAACGGGAG
CGGAACGGAATTCACTGGAGATATAACAGA|CGGAACGGAATCCGCCTTAACTAAGGATCA
TGCAGGCCGTACGGATCAAGTTGGCCTACG|GAATACCGCGGAACGGAATAGAGCACCGCG
CGGAATGTCGCCGTGGTCGTTAGTCCAAGC|AGAAACTGGCACGTGTTGGCCCTCTCTTTT
GCCGTGGTCGTTAGTCCAAGCTGCGCTATA|CACGTGTTGGCCCTCTCTTTTGATACGACT
TAACAGAGCGAGATATAACAGAGCACCGCG|CGGAACGGAATGATTTTGTATTCTTCATGG
GCGGAACGGAATAAGGGGTACAAATTCTGA|CTACGGCCATGAGTCTATTCGGATTGACGC
ATTCCATATGCGGAGATATAACAGAGCACC|ATCAATTAGGTGATGTAGGGGGAGATATAA
GTTAGAGAGCATGGAGGATTTACGGGAGAT|ACGGAATAACAAGTTGAGACAGTCTACTGA
GTGTTAGAGAGCATGGAGGATTTACGGGAG|GAACGGAATAACAAGTTGAGACAGTCTACT
GTGAACATATCCACCTCTGAGGAAATCCAT|AGCAAAACAAGGAAACGGGAGATTTGACGG
CGGGAGATTTGACGGTCCCAAGAATACAGT|TACCAGTAACACGGAATAAACGTCCAGATT
GGCACGTGTTGGCCCTCTCTTTTGATACGA|GAACGGAATAATGTCTAGGGGAGATATAAC
ATAACATAGCGTAGCGCCAGTGCTCATATC|ACTTAGAGTCGTTACGTTTCCTATCACATG
ATATAACAGAGCACCGCGGAACGGAATAAT|CGCGCAGCTGTGAACGATTGGATGGTCGGA
TACCAACACTTCAGCTTCACACTTTATTTC|TAAGGTCACTAGTCATCGGGGAGTACGGCC
CATATCCACCTCTGAGGAAATCCATCCACA|AACAAGGAAACGGGAGATTTGACGGTCCCA
GGGAGATATAACAGAGCACCGCGGAACGGA|GCATGCGCGCAGCTGTGAACGATTGGATGG
ACGGAATTCACTGGAGATATAACAGAGCAC|ACGGAATCCGCCTTAACTAAGGATCAGTCC
AGCACCGCGGAACGGAATACCGCGGAACGG|TCTTCATGGCTGGCACCATGCCTGCTCAGG
GCGCGCAGCTGTGAACGATTGGATGGTCGG|ATTCTGAGGAGTTTATTCCATATGCGGAGA
AATGCTGGGCAAGCATGCGCGCAGCTGTGA|GGAATAAGGGGTACAAATTCTGAGGAGTTT
CTTAGAGTCGTTACGTTTCCTATCACATGC|AGAGCACCGCGGAACGGAATGAAGGGGCTG
TCTCTACGAGATATAACAGAGCACCGCGGA|AGATATAACAGAGCACCGCGGAACGGAATC
ACGGAATAAGGGGTACAAATTCTGAGGAGT|GCCATGAGTCTATTCGGATTGACGCAAGTG
GGAGATATAACGAGATATAACAGAGCGAGA|GATATAACAGAGCACCGCGGAACGGAATGA
AACGGAATGTCGCCGTGGTCGTTAGTCCAA|TCAGAAACTGGCACGTGTTGGCCCTCTCTT
GATATAACAGAGCACCGCGGAACGGAATAA|AGAGCACCGCGGAACGGAATCGCGACCCCT
TTCCGCCAGGACGGTATTTTTGAGATATAA|TGCAGGCCGTACGGATCAAGTTGGCCTACG
ACGGAATGATTTTGTATTCTTCATGGCTGG|CACCGCGGAACGGAATGTGTTAGAGAGCAT
CGCGTGTTTCCGGTGAGATATAACAGAGCA|TGCTCATATCCTGGGAGATATAACAGAGCA
ACAGAGCGAGATATAACAGAGCACCGCGGA|GAACGGAATGATTTTGTATTCTTCATGGCT
CGCGGAACGGAATGAAGGGGCTGGTGCAGG|GATATAACAGAGCACCGCGGAACGGAATAC
ATACCAGTAACACGGAATAAACGTCCAGAT|GCTTGGACACACATGCTGTCTATGTCATTC
CGCAAGTGAAATCAATTAGGTGATGTAGGG|GCGTCGGTTCGAGTCTCTGTGTTATGAGCA
AATCGCGACCCCTTTGTTCACGTGTTATGG|ACAGAGCACCGCGGAACGGAATGCAACAGT
TATGCGGAGATATAACAGAGCACCGCGGAA|TAGGTGATGTAGGGGGAGATATAACAGAGC
ACAGTACCCACCGAGTATTAGATTGATACC|ACGCGCCGGCCTTGTACGAAAAGTAGCTTG
AACAGAGCACCGCGGAACGGGAGATATAAC|CGTATAAATGCTGGGCAAGCATGCGCGCAG
AGATATAACAGAGCACCGCGGAACGGAATG|ATCCTGCAACTGAGCGCTGAGCTACGATGG
GCGGAACGGAATTCACTGGAGATATAACAG|GCGGAACGGAATCCGCCTTAACTAAGGATC
ATAACAGAGCACCGCGGAACGGAATACCGC|TTTGTATTCTTCATGGCTGGCACCATGCCT
GTATTCTTCATGGCTGGCACCATGCCTGCT|AATGTGTTAGAGAGCATGGAGGATTTACGG
CCGCCAGGACGGTATTTTTGAGATATAACA|CAGGCCGTACGGATCAAGTTGGCCTACGTA
TCGTTAGTCCAAGCTGCGCTATAACATAGC|TGGCCCTCTCTTTTGATACGACTTAGAGTC
GCACCGCGGAACGGAATCCGCCTTAACTAA|ATTTTTGAGATATAACAGAGCACCGCGGAA
GCACCGCGGAACGGAATGTCGCCGTGGTCG|GTCCGATGCTCAGAAACTGGCACGTGTTGG
AGTTGCATTACAGACGGGTTTATTGGTACA|AATACAGTGGGCCCTATACCAACACTTCAG
TAAACGTCCAGATTTATGGCTTTAAGGTCA|GTCTATGTCATTCTGGGACAACTGCAGTGA
GTCGTTAGTCCAAGCTGCGCTATAACATAG|TTGGCCCTCTCTTTTGATACGACTTAGAGT
TGTGTTAGAGAGCATGGAGGATTTACGGGA|GGAACGGAATAACAAGTTGAGACAGTCTAC
AACGGAATACCGCGGAACGGAATAGAGCAC|TGGCACCATGCCTGCTCAGGCCACCATTCT
CGGAATAATGTCTAGGGGAGATATAACAGA|ATGGTCGGAGATATAACGAGATATAACAGA
GTTTCCTATCACATGCATTCCGCCAGGACG|CGGAATGAAGGGGCTGGTGCAGGCCGTACG
CCCTTTGTTCACGTGTTATGGGGCGTGAGC|CGCGGAACGGAATGCAACAGTACCCACCGA
CGGAATAAACGTCCAGATTTATGGCTTTAA|ATGCTGTCTATGTCATTCTGGGACAACTGC
TTATTTCCGGGAGATATAACAGAGCACCGC|TACGGCCCGCCATCCTGCAACTGAGCGCTG
ATTCGGATTGACGCAAGTGAAATCAATTAG|TGACACGATCAGCGTCGGTTCGAGTCTCTG
CGTGTTTCCGGTGAGATATAACAGAGCACC|CTCATATCCTGGGAGATATAACAGAGCACC
ATGCGCGCAGCTGTGAACGATTGGATGGTC|AAATTCTGAGGAGTTTATTCCATATGCGGA
AACAGAGCACCGCGGAACGGAATGAAGGGG|AACAGAGCGAGATATAACAGAGCACCGCGG
TTCTCTCTACGAGATATAACAGAGCACCGC|CAGAGATATAACAGAGCACCGCGGAACGGA
CGTTAGTCCAAGCTGCGCTATAACATAGCG|GGCCCTCTCTTTTGATACGACTTAGAGTCG
CTGAGGAGTTTATTCCATATGCGGAGATAT|ACGCAAGTGAAATCAATTAGGTGATGTAGG
TTAGATTGATACCAGTAACACGGAATAAAC|GAAAAGTAGCTTGGACACACATGCTGTCTA
ATAGCGTAGCGCCAGTGCTCATATCCTGGG|GAGTCGTTACGTTTCCTATCACATGCATTC
ATAATGTCTAGGGGAGATATAACAGAGCAC|TCGGAGATATAACGAGATATAACAGAGCGA
TGTCGCCGTGGTCGTTAGTCCAAGCTGCGC|CTGGCACGTGTTGGCCCTCTCTTTTGATAC
GTTTATTGGTACAGAGATATAACAGAGCAC|ACCAACACTTCAGCTTCACACTTTATTTCC
TATTCTTCATGGCTGGCACCATGCCTGCTC|ATGTGTTAGAGAGCATGGAGGATTTACGGG
AGATATAACAGAGCACCGCGGAACGGAATG|AACTAAGGATCAGTCCGATGCTCAGAAACT
GAGATATAACAGAGCACCGCGGAACGGAAT|TAACTAAGGATCAGTCCGATGCTCAGAAAC
GTCTAGGGGAGATATAACAGAGCACCGCGG|GATATAACGAGATATAACAGAGCGAGATAT
GCGGAACGGAATACCGCGGAACGGAATAGA|TGGCTGGCACCATGCCTGCTCAGGCCACCA
TGTGAACATATCCACCTCTGAGGAAATCCA|GAGCAAAACAAGGAAACGGGAGATTTGACG
CGGAACGGAATATGACACGATCAGCGTCGG|ACCTCTGAGGAAATCCATCCACAGTAGTTG
CACTGGAGATATAACAGAGCACCGCGGAAC|CGCCTTAACTAAGGATCAGTCCGATGCTCA
GCATTACAGACGGGTTTATTGGTACAGAGA|CAGTGGGCCCTATACCAACACTTCAGCTTC
GAATCGCGACCCCTTTGTTCACGTGTTATG|AACAGAGCACCGCGGAACGGAATGCAACAG
ATCCACAGTAGTTGCATTACAGACGGGTTT|GGTCCCAAGAATACAGTGGGCCCTATACCA
ACGGAATGTGTTAGAGAGCATGGAGGATTT|CACCGCGGAACGGAATAACAAGTTGAGACA
CGGAATAGAGCACCGCGGAACGGAATAAGG|AGGCCACCATTCTGCTACGGCCATGAGTCT
GATATAACGAGATATAACAGAGCGAGATAT|ATAACAGAGCACCGCGGAACGGAATGATTT
CAGCGTCGGTTCGAGTCTCTGTGTTATGAG|CAGTAGTTGCATTACAGACGGGTTTATTGG
GCGGAACGGAATGAAGGGGCTGGTGCAGGC|ATATAACAGAGCACCGCGGAACGGAATACC
AGGATTTACGGGAGATATAACAGAGCACCG|TGAGACAGTCTACTGACTGTGAACATATCC
ATATAACAGAGCACCGCGGAACGGAATGAA|ATATAACAGAGCGAGATATAACAGAGCACC
GGAGATATAACAGAGCACCGCGGAACGGAA|TCCGCCAGGACGGTATTTTTGAGATATAAC
TATTAGATTGATACCAGTAACACGGAATAA|ACGAAAAGTAGCTTGGACACACATGCTGTC
CAGCTTCACACTTTATTTCCGGGAGATATA|GTCATCGGGGAGTACGGCCCGCCATCCTGC
ACATAGCGTAGCGCCAGTGCTCATATCCTG|TAGAGTCGTTACGTTTCCTATCACATGCAT
GATATAACAGAGCACCGCGGAACGGAATGA|GTAGGGGGAGATATAACAGAGCACCGCGGA
AGCACCGCGGAACGGGAGATATAACAGAGC|AAATGCTGGGCAAGCATGCGCGCAGCTGTG
GCATTCCGCCAGGACGGTATTTTTGAGATA|TGGTGCAGGCCGTACGGATCAAGTTGGCCT
GCGCCAGTGCTCATATCCTGGGAGATATAA|ACGTTTCCTATCACATGCATTCCGCCAGGA
CGGATCAAGTTGGCCTACGTATAAATGCTG|AACGGAATAGAGCACCGCGGAACGGAATAA
GATATAACAGAGCACCGCGGAACGGAATAC|GATTTTGTATTCTTCATGGCTGGCACCATG
GCCATGAGTCTATTCGGATTGACGCAAGTG|GGAACGGAATATGACACGATCAGCGTCGGT
AAACAAGGAAACGGGAGATTTGACGGTCCC|TATTAGATTGATACCAGTAACACGGAATAA
GTGAGATATAACAGAGCACCGCGGAACGGA|GGGAGATATAACAGAGCACCGCGGAACGGA
TGCTCAGGCCACCATTCTGCTACGGCCATG|ACGGGAGATATAACAGAGCACCGCGGAACG
ATATAACAGAGCACCGCGGAACGGAATGTG|CTCTACGAGATATAACAGAGCACCGCGGAA
TGTGAACGATTGGATGGTCGGAGATATAAC|AGTTTATTCCATATGCGGAGATATAACAGA
ACAAGGAAACGGGAGATTTGACGGTCCCAA|TTAGATTGATACCAGTAACACGGAATAAAC
AGGTGCACCGCGTGTTTCCGGTGAGATATA|AGCGCCAGTGCTCATATCCTGGGAGATATA
GTTAGGTGCACCGCGTGTTTCCGGTGAGAT|CGTAGCGCCAGTGCTCATATCCTGGGAGAT
CTATACCAACACTTCAGCTTCACACTTTAT|CTTTAAGGTCACTAGTCATCGGGGAGTACG
GATATAACAGAGCACCGCGGAACGGAATCC|GCCAGGACGGTATTTTTGAGATATAACAGA
CGGATTGACGCAAGTGAAATCAATTAGGTG|CACGATCAGCGTCGGTTCGAGTCTCTGTGT
TGGCTTTAAGGTCACTAGTCATCGGGGAGT|GACAACTGCAGTGATTAATCCGGTCAATCT
TTCCATATGCGGAGATATAACAGAGCACCG|TCAATTAGGTGATGTAGGGGGAGATATAAC
ATAACAGAGCACCGCGGAACGGAATGAAGG|ATAACAGAGCGAGATATAACAGAGCACCGC
AGTGAAATCAATTAGGTGATGTAGGGGGAG|CGGTTCGAGTCTCTGTGTTATGAGCATTCT
GAATAGAGCACCGCGGAACGGAATAAGGGG|GCCACCATTCTGCTACGGCCATGAGTCTAT
CTAGTCATCGGGGAGTACGGCCCGCCATCC|TTAATCCGGTCAATCTTTCTCCGTTCTTGT
CAGAGCGAGATATAACAGAGCACCGCGGAA|AACGGAATGATTTTGTATTCTTCATGGCTG
AGTAGTTGCATTACAGACGGGTTTATTGGT|AAGAATACAGTGGGCCCTATACCAACACTT
TCAGGCCACCATTCTGCTACGGCCATGAGT|GGAGATATAACAGAGCACCGCGGAACGGAA
AAGCTGCGCTATAACATAGCGTAGCGCCAG|TTTTGATACGACTTAGAGTCGTTACGTTTC
CCTTTGTTCACGTGTTATGGGGCGTGAGCA|GCGGAACGGAATGCAACAGTACCCACCGAG
CCACCGAGTATTAGATTGATACCAGTAACA|GGCCTTGTACGAAAAGTAGCTTGGACACAC
GTGAGCAAAACAAGGAAACGGGAGATTTGA|CACCGAGTATTAGATTGATACCAGTAACAC
AATCCATCCACAGTAGTTGCATTACAGACG|TTGACGGTCCCAAGAATACAGTGGGCCCTA
GAATAAACGTCCAGATTTATGGCTTTAAGG|GCTGTCTATGTCATTCTGGGACAACTGCAG
ATCCTGGGAGATATAACAGAGCACCGCGGA|ATGCATTCCGCCAGGACGGTATTTTTGAGA
TAATGTCTAGGGGAGATATAACAGAGCACC|CGGAGATATAACGAGATATAACAGAGCGAG
GGGGAGATATAACAGAGCACCGCGGAACGG|CATTCTCTCTACGAGATATAACAGAGCACC
ACGGAATAGAGCACCGCGGAACGGAATAAG|CAGGCCACCATTCTGCTACGGCCATGAGTC
GGAGATATAACAGAGCACCGCGGAACGGAA|TTCTCTCTACGAGATATAACAGAGCACCGC
TTCCGGTGAGATATAACAGAGCACCGCGGA|ATCCTGGGAGATATAACAGAGCACCGCGGA
TTAGAGAGCATGGAGGATTTACGGGAGATA|CGGAATAACAAGTTGAGACAGTCTACTGAC
GAGGAAATCCATCCACAGTAGTTGCATTAC|GAGATTTGACGGTCCCAAGAATACAGTGGG
GGAAATCCATCCACAGTAGTTGCATTACAG|GATTTGACGGTCCCAAGAATACAGTGGGCC
GGATTTACGGGAGATATAACAGAGCACCGC|GAGACAGTCTACTGACTGTGAACATATCCA
TAGATTGATACCAGTAACACGGAATAAACG|AAAAGTAGCTTGGACACACATGCTGTCTAT
CACCGCGTGTTTCCGGTGAGATATAACAGA|CAGTGCTCATATCCTGGGAGATATAACAGA
CGGGAGATATAACAGAGCACCGCGGAACGG|CGCCATCCTGCAACTGAGCGCTGAGCTACG
CGGAACGGAATACCGCGGAACGGAATAGAG|GGCTGGCACCATGCCTGCTCAGGCCACCAT
GCACCGCGGAACGGAATAAGGGGTACAAAT|TTCTGCTACGGCCATGAGTCTATTCGGATT
CGGAATCCGCCTTAACTAAGGATCAGTCCG|ATAACAGAGCACCGCGGAACGGGAGATATA
CGGTCCCAAGAATACAGTGGGCCCTATACC|GGAATAAACGTCCAGATTTATGGCTTTAAG
TCACACTTTATTTCCGGGAGATATAACAGA|CGGGGAGTACGGCCCGCCATCCTGCAACTG
TGGCCTACGTATAAATGCTGGGCAAGCATG|AGCACCGCGGAACGGAATAAGGGGTACAAA
CTTTAAGGTCACTAGTCATCGGGGAGTACG|AACTGCAGTGATTAATCCGGTCAATCTTTC
ATGTCTAGGGGAGATATAACAGAGCACCGC|GAGATATAACGAGATATAACAGAGCGAGAT
ATATCCACCTCTGAGGAAATCCATCCACAG|ACAAGGAAACGGGAGATTTGACGGTCCCAA
AACGAGATATAACAGAGCGAGATATAACAG|AGAGCACCGCGGAACGGAATGATTTTGTAT
GTCGGTTCGAGTCTCTGTGTTATGAGCATT|AGTTGCATTACAGACGGGTTTATTGGTACA
TATCACATGCATTCCGCCAGGACGGTATTT|GAAGGGGCTGGTGCAGGCCGTACGGATCAA
CGAGTATTAGATTGATACCAGTAACACGGA|TTGTACGAAAAGTAGCTTGGACACACATGC
GCGGAACGGGAGATATAACAGAGCACCGCG|TGGGCAAGCATGCGCGCAGCTGTGAACGAT
TATAACAGAGCACCGCGGAACGGGAGATAT|CTACGTATAAATGCTGGGCAAGCATGCGCG
GCTTTAAGGTCACTAGTCATCGGGGAGTAC|CAACTGCAGTGATTAATCCGGTCAATCTTT
GTAGCGCCAGTGCTCATATCCTGGGAGATA|GTTACGTTTCCTATCACATGCATTCCGCCA
TGAGGAGTTTATTCCATATGCGGAGATATA|CGCAAGTGAAATCAATTAGGTGATGTAGGG
CGCAGCTGTGAACGATTGGATGGTCGGAGA|CTGAGGAGTTTATTCCATATGCGGAGATAT
GAGATATAACAGAGCACCGCGGAACGGAAT|CATCCTGCAACTGAGCGCTGAGCTACGATG
GATGCTCAGAAACTGGCACGTGTTGGCCCT|AACAGAGCACCGCGGAACGGAATAATGTCT
AGCGTCGGTTCGAGTCTCTGTGTTATGAGC|AGTAGTTGCATTACAGACGGGTTTATTGGT
AATGCAACAGTACCCACCGAGTATTAGATT|ATGGGCACGCGCCGGCCTTGTACGAAAAGT
TATTCGGATTGACGCAAGTGAAATCAATTA|ATGACACGATCAGCGTCGGTTCGAGTCTCT
CACGTGTTATGGGGCGTGAGCAAAACAAGG|GAATGCAACAGTACCCACCGAGTATTAGAT
CAACAGTACCCACCGAGTATTAGATTGATA|GCACGCGCCGGCCTTGTACGAAAAGTAGCT
AACATATCCACCTCTGAGGAAATCCATCCA|AAAACAAGGAAACGGGAGATTTGACGGTCC
AAGGAAACGGGAGATTTGACGGTCCCAAGA|AGATTGATACCAGTAACACGGAATAAACGT
AGGGGGAGATATAACAGAGCACCGCGGAAC|AGCATTCTCTCTACGAGATATAACAGAGCA
ACCGCGGAACGGAATACCGCGGAACGGAAT|TCATGGCTGGCACCATGCCTGCTCAGGCCA
GTTAGTCCAAGCTGCGCTATAACATAGCGT|GCCCTCTCTTTTGATACGACTTAGAGTCGT
AGAGATATAACAGAGCACCGCGGAACGGAA|GCTTCACACTTTATTTCCGGGAGATATAAC
CTCTTTTGATACGACTTAGAGTCGTTACGT|AGGGGAGATATAACAGAGCACCGCGGAACG
ACACTTTATTTCCGGGAGATATAACAGAGC|GGGAGTACGGCCCGCCATCCTGCAACTGAG
GAGCACCGCGGAACGGAATACCGCGGAACG|TTCTTCATGGCTGGCACCATGCCTGCTCAG
AGCACCGCGGAACGGAATGTGTTAGAGAGC|ATATAACAGAGCACCGCGGAACGGAATAAC
GCACCGCGGAACGGGAGATATAACAGAGCA|AATGCTGGGCAAGCATGCGCGCAGCTGTGA
TTTGTATTCTTCATGGCTGGCACCATGCCT|CGGAATGTGTTAGAGAGCATGGAGGATTTA
CCACCATTCTGCTACGGCCATGAGTCTATT|TATAACAGAGCACCGCGGAACGGAATATGA
GAACGGAATGTGTTAGAGAGCATGGAGGAT|AGCACCGCGGAACGGAATAACAAGTTGAGA
ATATAACAGAGCGAGATATAACAGAGCACC|CCGCGGAACGGAATGATTTTGTATTCTTCA
GAACATATCCACCTCTGAGGAAATCCATCC|CAAAACAAGGAAACGGGAGATTTGACGGTC
ACCAACACTTCAGCTTCACACTTTATTTCC|AAGGTCACTAGTCATCGGGGAGTACGGCCC
CGGAATTCACTGGAGATATAACAGAGCACC|CGGAATCCGCCTTAACTAAGGATCAGTCCG
CCGAGTATTAGATTGATACCAGTAACACGG|CTTGTACGAAAAGTAGCTTGGACACACATG
CACGTGTTGGCCCTCTCTTTTGATACGACT|ACGGAATAATGTCTAGGGGAGATATAACAG
GAATAACAAGTTGAGACAGTCTACTGACTG|ACCCCTTTGTTCACGTGTTATGGGGCGTGA
CTCTACGAGATATAACAGAGCACCGCGGAA|GATATAACAGAGCACCGCGGAACGGAATCG
CATGCGCGCAGCTGTGAACGATTGGATGGT|CAAATTCTGAGGAGTTTATTCCATATGCGG
TCCACAGTAGTTGCATTACAGACGGGTTTA|GTCCCAAGAATACAGTGGGCCCTATACCAA
TTGGCCTACGTATAAATGCTGGGCAAGCAT|GAGCACCGCGGAACGGAATAAGGGGTACAA
CTCTGTGTTATGAGCATTCTCTCTACGAGA|GACGGGTTTATTGGTACAGAGATATAACAG
CTCAGGCCACCATTCTGCTACGGCCATGAG|GGGAGATATAACAGAGCACCGCGGAACGGA
GTAGTTGCATTACAGACGGGTTTATTGGTA|AGAATACAGTGGGCCCTATACCAACACTTC
TCTGAGGAGTTTATTCCATATGCGGAGATA|GACGCAAGTGAAATCAATTAGGTGATGTAG
TGAACGATTGGATGGTCGGAGATATAACGA|TTTATTCCATATGCGGAGATATAACAGAGC
GTTCGAGTCTCTGTGTTATGAGCATTCTCT|GCATTACAGACGGGTTTATTGGTACAGAGA
TAACAAGTTGAGACAGTCTACTGACTGTGA|CCTTTGTTCACGTGTTATGGGGCGTGAGCA
GATTGACGCAAGTGAAATCAATTAGGTGAT|CGATCAGCGTCGGTTCGAGTCTCTGTGTTA
ATAACAGAGCACCGCGGAACGGAATGTCGC|AAGGATCAGTCCGATGCTCAGAAACTGGCA
GCGACCCCTTTGTTCACGTGTTATGGGGCG|AGCACCGCGGAACGGAATGCAACAGTACCC
ATTTGACGGTCCCAAGAATACAGTGGGCCC|TAACACGGAATAAACGTCCAGATTTATGGC
AGCAAAACAAGGAAACGGGAGATTTGACGG|CGAGTATTAGATTGATACCAGTAACACGGA
TTAAGGTCACTAGTCATCGGGGAGTACGGC|CTGCAGTGATTAATCCGGTCAATCTTTCTC
CGCGGAACGGAATAATGTCTAGGGGAGATA|CGATTGGATGGTCGGAGATATAACGAGATA
TGGCACCATGCCTGCTCAGGCCACCATTCT|CATGGAGGATTTACGGGAGATATAACAGAG
TTATTGGTACAGAGATATAACAGAGCACCG|CAACACTTCAGCTTCACACTTTATTTCCGG
GGGAGATATAACAGAGCACCGCGGAACGGA|GCCATCCTGCAACTGAGCGCTGAGCTACGA
CAGCTGTGAACGATTGGATGGTCGGAGATA|GAGGAGTTTATTCCATATGCGGAGATATAA
GAGTCTATTCGGATTGACGCAAGTGAAATC|GGAATATGACACGATCAGCGTCGGTTCGAG
CGTTACGTTTCCTATCACATGCATTCCGCC|GCGGAACGGAATGAAGGGGCTGGTGCAGGC
TTGATACCAGTAACACGGAATAAACGTCCA|GTAGCTTGGACACACATGCTGTCTATGTCA
GCAAGTGAAATCAATTAGGTGATGTAGGGG|CGTCGGTTCGAGTCTCTGTGTTATGAGCAT
CACCGCGGAACGGGAGATATAACAGAGCAC|ATGCTGGGCAAGCATGCGCGCAGCTGTGAA
AGAGCACCGCGGAACGGAATAACAAGTTGA|GCGGAACGGAATCGCGACCCCTTTGTTCAC
TGGTACAGAGATATAACAGAGCACCGCGGA|ACTTCAGCTTCACACTTTATTTCCGGGAGA
GCGTGTTTCCGGTGAGATATAACAGAGCAC|GCTCATATCCTGGGAGATATAACAGAGCAC
GGAGTTTATTCCATATGCGGAGATATAACA|AAGTGAAATCAATTAGGTGATGTAGGGGGA
GTAGGGGGAGATATAACAGAGCACCGCGGA|TGAGCATTCTCTCTACGAGATATAACAGAG
TACGTATAAATGCTGGGCAAGCATGCGCGC|CGCGGAACGGAATAAGGGGTACAAATTCTG
ATGGAGGATTTACGGGAGATATAACAGAGC|AAGTTGAGACAGTCTACTGACTGTGAACAT
CGTCGGTTCGAGTCTCTGTGTTATGAGCAT|TAGTTGCATTACAGACGGGTTTATTGGTAC
GGCTGGTGCAGGCCGTACGGATCAAGTTGG|GGAACGGAATACCGCGGAACGGAATAGAGC
ACGTTTCCTATCACATGCATTCCGCCAGGA|AACGGAATGAAGGGGCTGGTGCAGGCCGTA
GTCTACTGACTGTGAACATATCCACCTCTG|TATGGGGCGTGAGCAAAACAAGGAAACGGG
AGAGCACCGCGGAACGGAATAAGGGGTACA|CCATTCTGCTACGGCCATGAGTCTATTCGG
TTTGAGATATAACAGAGCACCGCGGAACGG|AGTTGGCCTACGTATAAATGCTGGGCAAGC
GATACGACTTAGAGTCGTTACGTTTCCTAT|ATATAACAGAGCACCGCGGAACGGAATGAA
CCACCTCTGAGGAAATCCATCCACAGTAGT|GGAAACGGGAGATTTGACGGTCCCAAGAAT
CTCATATCCTGGGAGATATAACAGAGCACC|ATCACATGCATTCCGCCAGGACGGTATTTT
ACGGAATACCGCGGAACGGAATAGAGCACC|GGCACCATGCCTGCTCAGGCCACCATTCTG
TCACATGCATTCCGCCAGGACGGTATTTTT|AGGGGCTGGTGCAGGCCGTACGGATCAAGT
CCATATGCGGAGATATAACAGAGCACCGCG|AATTAGGTGATGTAGGGGGAGATATAACAG
CGGCCATGAGTCTATTCGGATTGACGCAAG|GCGGAACGGAATATGACACGATCAGCGTCG
ATGTGTTAGAGAGCATGGAGGATTTACGGG|CGGAACGGAATAACAAGTTGAGACAGTCTA
GAATAAGGGGTACAAATTCTGAGGAGTTTA|ATGAGTCTATTCGGATTGACGCAAGTGAAA
GAAATCAATTAGGTGATGTAGGGGGAGATA|TTCGAGTCTCTGTGTTATGAGCATTCTCTC
CTGGCACGTGTTGGCCCTCTCTTTTGATAC|CGGAACGGAATAATGTCTAGGGGAGATATA
AGATATAACAGAGCACCGCGGAACGGAATA|TGATTTTGTATTCTTCATGGCTGGCACCAT
CGGAACGGGAGATATAACAGAGCACCGCGG|GGGCAAGCATGCGCGCAGCTGTGAACGATT
AGAAACTGGCACGTGTTGGCCCTCTCTTTT|CACCGCGGAACGGAATAATGTCTAGGGGAG
TTACGTTTCCTATCACATGCATTCCGCCAG|GGAACGGAATGAAGGGGCTGGTGCAGGCCG
GGAATAAACGTCCAGATTTATGGCTTTAAG|TGCTGTCTATGTCATTCTGGGACAACTGCA
GAGATATAACAGAGCACCGCGGAACGGAAT|TCTCTCTACGAGATATAACAGAGCACCGCG
AGTCTCTGTGTTATGAGCATTCTCTCTACG|ACAGACGGGTTTATTGGTACAGAGATATAA
CGGGTTTATTGGTACAGAGATATAACAGAG|TATACCAACACTTCAGCTTCACACTTTATT
GAGGATTTACGGGAGATATAACAGAGCACC|TTGAGACAGTCTACTGACTGTGAACATATC
GAACGGAATAGAGCACCGCGGAACGGAATA|CTCAGGCCACCATTCTGCTACGGCCATGAG
CCGCGGAACGGAATATGACACGATCAGCGT|TCCACCTCTGAGGAAATCCATCCACAGTAG
AGCATGCGCGCAGCTGTGAACGATTGGATG|TACAAATTCTGAGGAGTTTATTCCATATGC
CATGAGTCTATTCGGATTGACGCAAGTGAA|AACGGAATATGACACGATCAGCGTCGGTTC
CGGTGAGATATAACAGAGCACCGCGGAACG|CTGGGAGATATAACAGAGCACCGCGGAACG
GTCTCTGTGTTATGAGCATTCTCTCTACGA|CAGACGGGTTTATTGGTACAGAGATATAAC
GGGCCCTATACCAACACTTCAGCTTCACAC|TATGGCTTTAAGGTCACTAGTCATCGGGGA
GACTTAGAGTCGTTACGTTTCCTATCACAT|ACAGAGCACCGCGGAACGGAATGAAGGGGC
ACTGGCACGTGTTGGCCCTCTCTTTTGATA|GCGGAACGGAATAATGTCTAGGGGAGATAT
CGGAACGGAATGTCGCCGTGGTCGTTAGTC|TGCTCAGAAACTGGCACGTGTTGGCCCTCT
TGGTGCAGGCCGTACGGATCAAGTTGGCCT|ACGGAATACCGCGGAACGGAATAGAGCACC
AGTCTATTCGGATTGACGCAAGTGAAATCA|GAATATGACACGATCAGCGTCGGTTCGAGT
ACCGCGGAACGGAATGTCGCCGTGGTCGTT|CCGATGCTCAGAAACTGGCACGTGTTGGCC
TATTTTTGAGATATAACAGAGCACCGCGGA|ATCAAGTTGGCCTACGTATAAATGCTGGGC
GTCCAAGCTGCGCTATAACATAGCGTAGCG|TCTCTTTTGATACGACTTAGAGTCGTTACG
AATGTGTTAGAGAGCATGGAGGATTTACGG|GCGGAACGGAATAACAAGTTGAGACAGTCT
GCCCTCTCTTTTGATACGACTTAGAGTCGT|TGTCTAGGGGAGATATAACAGAGCACCGCG
TTATTCCATATGCGGAGATATAACAGAGCA|AAATCAATTAGGTGATGTAGGGGGAGATAT
CCGCGGAACGGAATGATTTTGTATTCTTCA|AACAGAGCACCGCGGAACGGAATGTGTTAG
TGAAATCAATTAGGTGATGTAGGGGGAGAT|GTTCGAGTCTCTGTGTTATGAGCATTCTCT
GCTATAACATAGCGTAGCGCCAGTGCTCAT|ACGACTTAGAGTCGTTACGTTTCCTATCAC
CACATGCATTCCGCCAGGACGGTATTTTTG|GGGGCTGGTGCAGGCCGTACGGATCAAGTT
AGTCGTTACGTTTCCTATCACATGCATTCC|ACCGCGGAACGGAATGAAGGGGCTGGTGCA
ATAACAGAGCGAGATATAACAGAGCACCGC|GCGGAACGGAATGATTTTGTATTCTTCATG
GAATGCAACAGTACCCACCGAGTATTAGAT|GATGGGCACGCGCCGGCCTTGTACGAAAAG
GGAACGGAATGTGTTAGAGAGCATGGAGGA|GAGCACCGCGGAACGGAATAACAAGTTGAG
AATAAACGTCCAGATTTATGGCTTTAAGGT|CTGTCTATGTCATTCTGGGACAACTGCAGT
CGGAATGATTTTGTATTCTTCATGGCTGGC|ACCGCGGAACGGAATGTGTTAGAGAGCATG
CGGAATCGCGACCCCTTTGTTCACGTGTTA|ATAACAGAGCACCGCGGAACGGAATGCAAC
GATATAACAGAGCACCGCGGAACGGAATGC|TCCTGCAACTGAGCGCTGAGCTACGATGGG
ATTGACGCAAGTGAAATCAATTAGGTGATG|GATCAGCGTCGGTTCGAGTCTCTGTGTTAT
GGAGATATAACAGAGCACCGCGGAACGGAA|CGAGATATAACAGAGCGAGATATAACAGAG
TAGAGCACCGCGGAACGGAATAAGGGGTAC|ACCATTCTGCTACGGCCATGAGTCTATTCG
TGAACATATCCACCTCTGAGGAAATCCATC|GCAAAACAAGGAAACGGGAGATTTGACGGT
ATGCGGAGATATAACAGAGCACCGCGGAAC|AGGTGATGTAGGGGGAGATATAACAGAGCA
CACCGCGGAACGGAATGTGTTAGAGAGCAT|ATAACAGAGCACCGCGGAACGGAATAACAA
TTTATGGCTTTAAGGTCACTAGTCATCGGG|CTGGGACAACTGCAGTGATTAATCCGGTCA
TATACCAACACTTCAGCTTCACACTTTATT|TTTAAGGTCACTAGTCATCGGGGAGTACGG
ATGGGGCGTGAGCAAAACAAGGAAACGGGA|CAGTACCCACCGAGTATTAGATTGATACCA
GTTGAGACAGTCTACTGACTGTGAACATAT|TTCACGTGTTATGGGGCGTGAGCAAAACAA
TTCGGATTGACGCAAGTGAAATCAATTAGG|GACACGATCAGCGTCGGTTCGAGTCTCTGT
AGCACCGCGGAACGGAATTCACTGGAGATA|AGCACCGCGGAACGGAATCCGCCTTAACTA
GGCAAGCATGCGCGCAGCTGTGAACGATTG|GGGGTACAAATTCTGAGGAGTTTATTCCAT
GCGGAACGGAATGCAACAGTACCCACCGAG|TGAGCTACGATGGGCACGCGCCGGCCTTGT
TAGAGAGCATGGAGGATTTACGGGAGATAT|GGAATAACAAGTTGAGACAGTCTACTGACT
GCACCGCGGAACGGAATGCAACAGTACCCA|AGCGCTGAGCTACGATGGGCACGCGCCGGC
GGAACGGAATGTCGCCGTGGTCGTTAGTCC|GCTCAGAAACTGGCACGTGTTGGCCCTCTC
TGTTAGAGAGCATGGAGGATTTACGGGAGA|AACGGAATAACAAGTTGAGACAGTCTACTG
TATTGGTACAGAGATATAACAGAGCACCGC|AACACTTCAGCTTCACACTTTATTTCCGGG
GGAACGGAATCGCGACCCCTTTGTTCACGT|AGATATAACAGAGCACCGCGGAACGGAATG
CTCTGAGGAAATCCATCCACAGTAGTTGCA|ACGGGAGATTTGACGGTCCCAAGAATACAG
AGATATAACAGAGCACCGCGGAACGGAATG|AGATATAACAGAGCGAGATATAACAGAGCA
TATAACAGAGCACCGCGGAACGGAATACCG|TTTTGTATTCTTCATGGCTGGCACCATGCC
CCGTACGGATCAAGTTGGCCTACGTATAAA|CGCGGAACGGAATAGAGCACCGCGGAACGG
GATATAACAGAGCACCGCGGAACGGAATAT|TGACTGTGAACATATCCACCTCTGAGGAAA
CGGAACGGAATAAGGGGTACAAATTCTGAG|TACGGCCATGAGTCTATTCGGATTGACGCA
AACTGGCACGTGTTGGCCCTCTCTTTTGAT|CGCGGAACGGAATAATGTCTAGGGGAGATA
TGCATTACAGACGGGTTTATTGGTACAGAG|ACAGTGGGCCCTATACCAACACTTCAGCTT
GCGGAACGGAATCCGCCTTAACTAAGGATC|TGAGATATAACAGAGCACCGCGGAACGGGA
GTCCAGATTTATGGCTTTAAGGTCACTAGT|TGTCATTCTGGGACAACTGCAGTGATTAAT
AACAAGGAAACGGGAGATTTGACGGTCCCA|ATTAGATTGATACCAGTAACACGGAATAAA
CCCTCTCTTTTGATACGACTTAGAGTCGTT|GTCTAGGGGAGATATAACAGAGCACCGCGG
AACGGAATGCAACAGTACCCACCGAGTATT|CTACGATGGGCACGCGCCGGCCTTGTACGA
CACCGCGGAACGGAATACCGCGGAACGGAA|TTCATGGCTGGCACCATGCCTGCTCAGGCC
ATTTACGGGAGATATAACAGAGCACCGCGG|GACAGTCTACTGACTGTGAACATATCCACC
CACCGCGGAACGGAATGTCGCCGTGGTCGT|TCCGATGCTCAGAAACTGGCACGTGTTGGC
CATTCTCTCTACGAGATATAACAGAGCACC|TACAGAGATATAACAGAGCACCGCGGAACG
CTACGGCCATGAGTCTATTCGGATTGACGC|ACCGCGGAACGGAATATGACACGATCAGCG
CAAGCTGCGCTATAACATAGCGTAGCGCCA|CTTTTGATACGACTTAGAGTCGTTACGTTT
TGTTCACGTGTTATGGGGCGTGAGCAAAAC|AACGGAATGCAACAGTACCCACCGAGTATT
GGCACCATGCCTGCTCAGGCCACCATTCTG|ATGGAGGATTTACGGGAGATATAACAGAGC
GTGAAATCAATTAGGTGATGTAGGGGGAGA|GGTTCGAGTCTCTGTGTTATGAGCATTCTC
GTGTTATGGGGCGTGAGCAAAACAAGGAAA|TGCAACAGTACCCACCGAGTATTAGATTGA
CGTTTCCTATCACATGCATTCCGCCAGGAC|ACGGAATGAAGGGGCTGGTGCAGGCCGTAC
TAAGGTCACTAGTCATCGGGGAGTACGGCC|TGCAGTGATTAATCCGGTCAATCTTTCTCC
CGAGATATAACAGAGCACCGCGGAACGGAA|AATGATTTTGTATTCTTCATGGCTGGCACC
GGGCGTGAGCAAAACAAGGAAACGGGAGAT|TACCCACCGAGTATTAGATTGATACCAGTA
GCCCTATACCAACACTTCAGCTTCACACTT|TGGCTTTAAGGTCACTAGTCATCGGGGAGT
GTGTTGGCCCTCTCTTTTGATACGACTTAG|GAATAATGTCTAGGGGAGATATAACAGAGC
CCGCGGAACGGAATAACAAGTTGAGACAGT|CGGAATCGCGACCCCTTTGTTCACGTGTTA
TTCTGAGGAGTTTATTCCATATGCGGAGAT|TGACGCAAGTGAAATCAATTAGGTGATGTA
CATCCACAGTAGTTGCATTACAGACGGGTT|CGGTCCCAAGAATACAGTGGGCCCTATACC
TCCGCCAGGACGGTATTTTTGAGATATAAC|GCAGGCCGTACGGATCAAGTTGGCCTACGT
TATAACAGAGCACCGCGGAACGGAATAATG|GCGCAGCTGTGAACGATTGGATGGTCGGAG
ACGGAATATGACACGATCAGCGTCGGTTCG|CTGAGGAAATCCATCCACAGTAGTTGCATT
TGGGCAAGCATGCGCGCAGCTGTGAACGAT|AAGGGGTACAAATTCTGAGGAGTTTATTCC
TGGATGGTCGGAGATATAACGAGATATAAC|ATATGCGGAGATATAACAGAGCACCGCGGA
GTTGCATTACAGACGGGTTTATTGGTACAG|ATACAGTGGGCCCTATACCAACACTTCAGC
ATCAATTAGGTGATGTAGGGGGAGATATAA|GAGTCTCTGTGTTATGAGCATTCTCTCTAC
GCTGTGAACGATTGGATGGTCGGAGATATA|GGAGTTTATTCCATATGCGGAGATATAACA
TTTTGATACGACTTAGAGTCGTTACGTTTC|GGAGATATAACAGAGCACCGCGGAACGGAA
CGCGGAACGGAATTCACTGGAGATATAACA|CGCGGAACGGAATCCGCCTTAACTAAGGAT
TGTCTAGGGGAGATATAACAGAGCACCGCG|AGATATAACGAGATATAACAGAGCGAGATA
TTCAGCTTCACACTTTATTTCCGGGAGATA|TAGTCATCGGGGAGTACGGCCCGCCATCCT
CTTAACTAAGGATCAGTCCGATGCTCAGAA|ACCGCGGAACGGGAGATATAACAGAGCACC
ATCAGCGTCGGTTCGAGTCTCTGTGTTATG|CACAGTAGTTGCATTACAGACGGGTTTATT
CAGTAACACGGAATAAACGTCCAGATTTAT|GGACACACATGCTGTCTATGTCATTCTGGG
CAGAGCACCGCGGAACGGAATGAAGGGGCT|CAGAGCGAGATATAACAGAGCACCGCGGAA
TATAACAGAGCACCGCGGAACGGAATATGA|ACTGTGAACATATCCACCTCTGAGGAAATC
ACGACTTAGAGTCGTTACGTTTCCTATCAC|TAACAGAGCACCGCGGAACGGAATGAAGGG
ATTACAGACGGGTTTATTGGTACAGAGATA|GTGGGCCCTATACCAACACTTCAGCTTCAC
TAGGTGCACCGCGTGTTTCCGGTGAGATAT|TAGCGCCAGTGCTCATATCCTGGGAGATAT
TCAAGTTGGCCTACGTATAAATGCTGGGCA|GAATAGAGCACCGCGGAACGGAATAAGGGG
GTCACTAGTCATCGGGGAGTACGGCCCGCC|GTGATTAATCCGGTCAATCTTTCTCCGTTC
AGGAAACGGGAGATTTGACGGTCCCAAGAA|GATTGATACCAGTAACACGGAATAAACGTC
CATGGAGGATTTACGGGAGATATAACAGAG|CAAGTTGAGACAGTCTACTGACTGTGAACA
ACGGTCCCAAGAATACAGTGGGCCCTATAC|CGGAATAAACGTCCAGATTTATGGCTTTAA
ACAGAGCACCGCGGAACGGAATGATTTTGT|GGAGATATAACAGAGCACCGCGGAACGGAA
TATAACAGAGCACCGCGGAACGGAATCCGC|CAGGACGGTATTTTTGAGATATAACAGAGC
GGGGGAGATATAACAGAGCACCGCGGAACG|GCATTCTCTCTACGAGATATAACAGAGCAC
GCACCGCGTGTTTCCGGTGAGATATAACAG|CCAGTGCTCATATCCTGGGAGATATAACAG
ACGTATAAATGCTGGGCAAGCATGCGCGCA|GCGGAACGGAATAAGGGGTACAAATTCTGA
GCGTCGGTTCGAGTCTCTGTGTTATGAGCA|GTAGTTGCATTACAGACGGGTTTATTGGTA
ACAGAGCACCGCGGAACGGAATGTCGCCGT|GATCAGTCCGATGCTCAGAAACTGGCACGT
AACGGAATGTGTTAGAGAGCATGGAGGATT|GCACCGCGGAACGGAATAACAAGTTGAGAC
GTTATGAGCATTCTCTCTACGAGATATAAC|TTTATTGGTACAGAGATATAACAGAGCACC
GCGGAACGGAATCGCGACCCCTTTGTTCAC|GGAGATATAACAGAGCACCGCGGAACGGAA
CTGTGAACATATCCACCTCTGAGGAAATCC|TGAGCAAAACAAGGAAACGGGAGATTTGAC
GGAACGGAATGCAACAGTACCCACCGAGTA|AGCTACGATGGGCACGCGCCGGCCTTGTAC
AAATTCTGAGGAGTTTATTCCATATGCGGA|GATTGACGCAAGTGAAATCAATTAGGTGAT
CGCCGTGGTCGTTAGTCCAAGCTGCGCTAT|GCACGTGTTGGCCCTCTCTTTTGATACGAC
TACAGAGATATAACAGAGCACCGCGGAACG|TCAGCTTCACACTTTATTTCCGGGAGATAT
GCACCGCGGAACGGAATCGCGACCCCTTTG|TTCCGGGAGATATAACAGAGCACCGCGGAA
GTTGGCCTACGTATAAATGCTGGGCAAGCA|AGAGCACCGCGGAACGGAATAAGGGGTACA
TGCATTCCGCCAGGACGGTATTTTTGAGAT|CTGGTGCAGGCCGTACGGATCAAGTTGGCC
ACGGAATGTCGCCGTGGTCGTTAGTCCAAG|CAGAAACTGGCACGTGTTGGCCCTCTCTTT
ACCCCTTTGTTCACGTGTTATGGGGCGTGA|ACCGCGGAACGGAATGCAACAGTACCCACC
CGGAGATATAACGAGATATAACAGAGCGAG|AGATATAACAGAGCACCGCGGAACGGAATG
CGGAACGGAATCGCGACCCCTTTGTTCACG|GAGATATAACAGAGCACCGCGGAACGGAAT
TGCACCGCGTGTTTCCGGTGAGATATAACA|GCCAGTGCTCATATCCTGGGAGATATAACA
AGGTGATGTAGGGGGAGATATAACAGAGCA|TGTGTTATGAGCATTCTCTCTACGAGATAT
CTGACTGTGAACATATCCACCTCTGAGGAA|GGCGTGAGCAAAACAAGGAAACGGGAGATT
TCTAGGGGAGATATAACAGAGCACCGCGGA|ATATAACGAGATATAACAGAGCGAGATATA
TTCTGCTACGGCCATGAGTCTATTCGGATT|AGAGCACCGCGGAACGGAATATGACACGAT
AGCACCGCGGAACGGAATATGACACGATCA|CATATCCACCTCTGAGGAAATCCATCCACA
ACCATGCCTGCTCAGGCCACCATTCTGCTA|GAGGATTTACGGGAGATATAACAGAGCACC
AGTCTACTGACTGTGAACATATCCACCTCT|TTATGGGGCGTGAGCAAAACAAGGAAACGG
CATGCCTGCTCAGGCCACCATTCTGCTACG|GGATTTACGGGAGATATAACAGAGCACCGC
TACGAGATATAACAGAGCACCGCGGAACGG|ATAACAGAGCACCGCGGAACGGAATCGCGA
TATAACAGAGCGAGATATAACAGAGCACCG|CGCGGAACGGAATGATTTTGTATTCTTCAT
TGCGCGCAGCTGTGAACGATTGGATGGTCG|AATTCTGAGGAGTTTATTCCATATGCGGAG
AGGAGTTTATTCCATATGCGGAGATATAAC|CAAGTGAAATCAATTAGGTGATGTAGGGGG
CGGAACGGAATGTGTTAGAGAGCATGGAGG|AGAGCACCGCGGAACGGAATAACAAGTTGA
AACGGAATGATTTTGTATTCTTCATGGCTG|GCACCGCGGAACGGAATGTGTTAGAGAGCA
GGTGAGATATAACAGAGCACCGCGGAACGG|TGGGAGATATAACAGAGCACCGCGGAACGG
GATATAACAGAGCACCGCGGAACGGGAGAT|GCCTACGTATAAATGCTGGGCAAGCATGCG
ACAAGTTGAGACAGTCTACTGACTGTGAAC|TTTGTTCACGTGTTATGGGGCGTGAGCAAA
ATTCCGCCAGGACGGTATTTTTGAGATATA|GTGCAGGCCGTACGGATCAAGTTGGCCTAC
ATTCTGAGGAGTTTATTCCATATGCGGAGA|TTGACGCAAGTGAAATCAATTAGGTGATGT
AGAGCACCGCGGAACGGAATATGACACGAT|AACATATCCACCTCTGAGGAAATCCATCCA
TGAGGAAATCCATCCACAGTAGTTGCATTA|GGAGATTTGACGGTCCCAAGAATACAGTGG
TTTTGAGATATAACAGAGCACCGCGGAACG|AAGTTGGCCTACGTATAAATGCTGGGCAAG
AAGGATCAGTCCGATGCTCAGAAACTGGCA|AACGGGAGATATAACAGAGCACCGCGGAAC
TCCGCCTTAACTAAGGATCAGTCCGATGCT|AGAGCACCGCGGAACGGGAGATATAACAGA
CAGAGCACCGCGGAACGGAATGTGTTAGAG|GAGATATAACAGAGCACCGCGGAACGGAAT
GAATGTCGCCGTGGTCGTTAGTCCAAGCTG|AAACTGGCACGTGTTGGCCCTCTCTTTTGA
CATTACAGACGGGTTTATTGGTACAGAGAT|AGTGGGCCCTATACCAACACTTCAGCTTCA
ACAGAGCACCGCGGAACGGAATATGACACG|TGAACATATCCACCTCTGAGGAAATCCATC
ATAAGGGGTACAAATTCTGAGGAGTTTATT|GAGTCTATTCGGATTGACGCAAGTGAAATC
AACAGAGCACCGCGGAACGGAATAATGTCT|CAGCTGTGAACGATTGGATGGTCGGAGATA
ATAACGAGATATAACAGAGCGAGATATAAC|ACAGAGCACCGCGGAACGGAATGATTTTGT
GGAGATATAACAGAGCACCGCGGAACGGAA|GATGTAGGGGGAGATATAACAGAGCACCGC
AGTATTAGATTGATACCAGTAACACGGAAT|GTACGAAAAGTAGCTTGGACACACATGCTG
TCATCGGGGAGTACGGCCCGCCATCCTGCA|TCCGGTCAATCTTTCTCCGTTCTTGTTAAG
AACGGGAGATATAACAGAGCACCGCGGAAC|CAAGCATGCGCGCAGCTGTGAACGATTGGA
AGCGCCAGTGCTCATATCCTGGGAGATATA|TACGTTTCCTATCACATGCATTCCGCCAGG
CACAGTAGTTGCATTACAGACGGGTTTATT|CCCAAGAATACAGTGGGCCCTATACCAACA
ACAGAGCACCGCGGAACGGAATGAAGGGGC|ACAGAGCGAGATATAACAGAGCACCGCGGA
ATTCTCTCTACGAGATATAACAGAGCACCG|ACAGAGATATAACAGAGCACCGCGGAACGG
AATAGAGCACCGCGGAACGGAATAAGGGGT|CCACCATTCTGCTACGGCCATGAGTCTATT
AGGATCAGTCCGATGCTCAGAAACTGGCAC|ACGGGAGATATAACAGAGCACCGCGGAACG
GGCCATGAGTCTATTCGGATTGACGCAAGT|CGGAACGGAATATGACACGATCAGCGTCGG
ATGCCTGCTCAGGCCACCATTCTGCTACGG|GATTTACGGGAGATATAACAGAGCACCGCG
ACAGAGATATAACAGAGCACCGCGGAACGG|CAGCTTCACACTTTATTTCCGGGAGATATA
GACGGGTTTATTGGTACAGAGATATAACAG|CCTATACCAACACTTCAGCTTCACACTTTA
GAGATATAACAGAGCGAGATATAACAGAGC|GCACCGCGGAACGGAATGATTTTGTATTCT
GAGACAGTCTACTGACTGTGAACATATCCA|ACGTGTTATGGGGCGTGAGCAAAACAAGGA
CTACGAGATATAACAGAGCACCGCGGAACG|TATAACAGAGCACCGCGGAACGGAATCGCG
TACGACTTAGAGTCGTTACGTTTCCTATCA|ATAACAGAGCACCGCGGAACGGAATGAAGG
ACGGGAGATTTGACGGTCCCAAGAATACAG|ATACCAGTAACACGGAATAAACGTCCAGAT
TTTCCGGTGAGATATAACAGAGCACCGCGG|TATCCTGGGAGATATAACAGAGCACCGCGG
AACAGAGCACCGCGGAACGGAATCGCGACC|CTTTATTTCCGGGAGATATAACAGAGCACC
CGATCAGCGTCGGTTCGAGTCTCTGTGTTA|TCCACAGTAGTTGCATTACAGACGGGTTTA
GGAACGGAATAACAAGTTGAGACAGTCTAC|ATCGCGACCCCTTTGTTCACGTGTTATGGG
GAGTTTATTCCATATGCGGAGATATAACAG|AGTGAAATCAATTAGGTGATGTAGGGGGAG
GGTCCCAAGAATACAGTGGGCCCTATACCA|GAATAAACGTCCAGATTTATGGCTTTAAGG
GATATAACAGAGCGAGATATAACAGAGCAC|ACCGCGGAACGGAATGATTTTGTATTCTTC
ATAACAGAGCACCGCGGAACGGAATAATGT|CGCAGCTGTGAACGATTGGATGGTCGGAGA
AGCACCGCGGAACGGAATGATTTTGTATTC|ATATAACAGAGCACCGCGGAACGGAATGTG
CGCGGAACGGAATAGAGCACCGCGGAACGG|CCTGCTCAGGCCACCATTCTGCTACGGCCA
TGCGCTATAACATAGCGTAGCGCCAGTGCT|GATACGACTTAGAGTCGTTACGTTTCCTAT
TACGGGAGATATAACAGAGCACCGCGGAAC|AGTCTACTGACTGTGAACATATCCACCTCT
CCCACCGAGTATTAGATTGATACCAGTAAC|CGGCCTTGTACGAAAAGTAGCTTGGACACA
GAACGGAATATGACACGATCAGCGTCGGTT|CTCTGAGGAAATCCATCCACAGTAGTTGCA
GTCATCGGGGAGTACGGCCCGCCATCCTGC|ATCCGGTCAATCTTTCTCCGTTCTTGTTAA
ATGTAGGGGGAGATATAACAGAGCACCGCG|TATGAGCATTCTCTCTACGAGATATAACAG
GCGGAACGGAATGTGTTAGAGAGCATGGAG|CAGAGCACCGCGGAACGGAATAACAAGTTG
CACCGCGGAACGGAATATGACACGATCAGC|TATCCACCTCTGAGGAAATCCATCCACAGT
ATATGCGGAGATATAACAGAGCACCGCGGA|TTAGGTGATGTAGGGGGAGATATAACAGAG
GGAATGTGTTAGAGAGCATGGAGGATTTAC|CCGCGGAACGGAATAACAAGTTGAGACAGT
TTCACGTGTTATGGGGCGTGAGCAAAACAA|CGGAATGCAACAGTACCCACCGAGTATTAG
GAGATATAACAGAGCACCGCGGAACGGAAT|CCGCCAGGACGGTATTTTTGAGATATAACA
GAGAGCATGGAGGATTTACGGGAGATATAA|AATAACAAGTTGAGACAGTCTACTGACTGT
CCCTATACCAACACTTCAGCTTCACACTTT|GGCTTTAAGGTCACTAGTCATCGGGGAGTA
CGCGACCCCTTTGTTCACGTGTTATGGGGC|GAGCACCGCGGAACGGAATGCAACAGTACC
GGGAGATATAACAGAGCACCGCGGAACGGA|ACGAGATATAACAGAGCGAGATATAACAGA
GCACCATGCCTGCTCAGGCCACCATTCTGC|TGGAGGATTTACGGGAGATATAACAGAGCA
GGATTGACGCAAGTGAAATCAATTAGGTGA|ACGATCAGCGTCGGTTCGAGTCTCTGTGTT
GAACGATTGGATGGTCGGAGATATAACGAG|TTATTCCATATGCGGAGATATAACAGAGCA
CAGATTTATGGCTTTAAGGTCACTAGTCAT|CATTCTGGGACAACTGCAGTGATTAATCCG
AATTCACTGGAGATATAACAGAGCACCGCG|AATCCGCCTTAACTAAGGATCAGTCCGATG
TTAGTCCAAGCTGCGCTATAACATAGCGTA|CCCTCTCTTTTGATACGACTTAGAGTCGTT
ATCAAGTTGGCCTACGTATAAATGCTGGGC|GGAATAGAGCACCGCGGAACGGAATAAGGG
CTTTGTTCACGTGTTATGGGGCGTGAGCAA|CGGAACGGAATGCAACAGTACCCACCGAGT
CACCGCGGAACGGAATGAAGGGGCTGGTGC|CGAGATATAACAGAGCACCGCGGAACGGAA
ACTTAGAGTCGTTACGTTTCCTATCACATG|CAGAGCACCGCGGAACGGAATGAAGGGGCT
TTCTTCATGGCTGGCACCATGCCTGCTCAG|GTGTTAGAGAGCATGGAGGATTTACGGGAG
ACGGAATGAAGGGGCTGGTGCAGGCCGTAC|ACAGAGCACCGCGGAACGGAATACCGCGGA
AGCTTCACACTTTATTTCCGGGAGATATAA|TCATCGGGGAGTACGGCCCGCCATCCTGCA
GCACCGCGGAACGGAATAATGTCTAGGGGA|TGAACGATTGGATGGTCGGAGATATAACGA
CGCGGAACGGAATGTCGCCGTGGTCGTTAG|GATGCTCAGAAACTGGCACGTGTTGGCCCT
TTTATTTCCGGGAGATATAACAGAGCACCG|GTACGGCCCGCCATCCTGCAACTGAGCGCT
GGGAGATATAACAGAGCACCGCGGAACGGA|ATTCTCTCTACGAGATATAACAGAGCACCG
GAGATATAACAGAGCACCGCGGAACGGGAG|TGGCCTACGTATAAATGCTGGGCAAGCATG
CGAGTCTCTGTGTTATGAGCATTCTCTCTA|TTACAGACGGGTTTATTGGTACAGAGATAT
GTTACGTTTCCTATCACATGCATTCCGCCA|CGGAACGGAATGAAGGGGCTGGTGCAGGCC
GAGTCTCTGTGTTATGAGCATTCTCTCTAC|TACAGACGGGTTTATTGGTACAGAGATATA
ACCGCGGAACGGAATATGACACGATCAGCG|ATCCACCTCTGAGGAAATCCATCCACAGTA
TCGGAGATATAACGAGATATAACAGAGCGA|GAGATATAACAGAGCACCGCGGAACGGAAT
AGTCCGATGCTCAGAAACTGGCACGTGTTG|GATATAACAGAGCACCGCGGAACGGAATAA
ACAGAGCACCGCGGAACGGAATTCACTGGA|ACAGAGCACCGCGGAACGGAATCCGCCTTA
CCGCGGAACGGAATAATGTCTAGGGGAGAT|ACGATTGGATGGTCGGAGATATAACGAGAT
CGACTTAGAGTCGTTACGTTTCCTATCACA|AACAGAGCACCGCGGAACGGAATGAAGGGG
AACTAAGGATCAGTCCGATGCTCAGAAACT|GCGGAACGGGAGATATAACAGAGCACCGCG
CGCGGAACGGAATATGACACGATCAGCGTC|CCACCTCTGAGGAAATCCATCCACAGTAGT
AGATATAACAGAGCGAGATATAACAGAGCA|CACCGCGGAACGGAATGATTTTGTATTCTT
GGCCTACGTATAAATGCTGGGCAAGCATGC|GCACCGCGGAACGGAATAAGGGGTACAAAT
GGCCCTATACCAACACTTCAGCTTCACACT|ATGGCTTTAAGGTCACTAGTCATCGGGGAG
GAATAATGTCTAGGGGAGATATAACAGAGC|GGTCGGAGATATAACGAGATATAACAGAGC
TAGCGCCAGTGCTCATATCCTGGGAGATAT|TTACGTTTCCTATCACATGCATTCCGCCAG
AATAATGTCTAGGGGAGATATAACAGAGCA|GTCGGAGATATAACGAGATATAACAGAGCG
TCCTATCACATGCATTCCGCCAGGACGGTA|AATGAAGGGGCTGGTGCAGGCCGTACGGAT
GGAATGTCGCCGTGGTCGTTAGTCCAAGCT|GAAACTGGCACGTGTTGGCCCTCTCTTTTG
GAACGGAATCCGCCTTAACTAAGGATCAGT|GATATAACAGAGCACCGCGGAACGGGAGAT
CAGAGATATAACAGAGCACCGCGGAACGGA|AGCTTCACACTTTATTTCCGGGAGATATAA
GTACAAATTCTGAGGAGTTTATTCCATATG|TTCGGATTGACGCAAGTGAAATCAATTAGG
TAACTAAGGATCAGTCCGATGCTCAGAAAC|CGCGGAACGGGAGATATAACAGAGCACCGC
CGTACGGATCAAGTTGGCCTACGTATAAAT|GCGGAACGGAATAGAGCACCGCGGAACGGA
CGGAACGGAATGAAGGGGCTGGTGCAGGCC|TATAACAGAGCACCGCGGAACGGAATACCG
TCCTGGGAGATATAACAGAGCACCGCGGAA|TGCATTCCGCCAGGACGGTATTTTTGAGAT
ATGCTCAGAAACTGGCACGTGTTGGCCCTC|ACAGAGCACCGCGGAACGGAATAATGTCTA
GATACCAGTAACACGGAATAAACGTCCAGA|AGCTTGGACACACATGCTGTCTATGTCATT
ATTAGGTGATGTAGGGGGAGATATAACAGA|CTCTGTGTTATGAGCATTCTCTCTACGAGA
CTCTCTACGAGATATAACAGAGCACCGCGG|GAGATATAACAGAGCACCGCGGAACGGAAT
TGGAGGATTTACGGGAGATATAACAGAGCA|AGTTGAGACAGTCTACTGACTGTGAACATA
ATTAGATTGATACCAGTAACACGGAATAAA|CGAAAAGTAGCTTGGACACACATGCTGTCT
TGGGAGATATAACAGAGCACCGCGGAACGG|ATTCCGCCAGGACGGTATTTTTGAGATATA
ATGAAGGGGCTGGTGCAGGCCGTACGGATC|GCACCGCGGAACGGAATACCGCGGAACGGA
CGGAACGGAATCCGCCTTAACTAAGGATCA|GAGATATAACAGAGCACCGCGGAACGGGAG
GAATCCGCCTTAACTAAGGATCAGTCCGAT|AACAGAGCACCGCGGAACGGGAGATATAAC
ATAACAGAGCACCGCGGAACGGAATGTGTT|CTACGAGATATAACAGAGCACCGCGGAACG
AGATTTGACGGTCCCAAGAATACAGTGGGC|AGTAACACGGAATAAACGTCCAGATTTATG
AATTAGGTGATGTAGGGGGAGATATAACAG|TCTCTGTGTTATGAGCATTCTCTCTACGAG
AACACTTCAGCTTCACACTTTATTTCCGGG|GTCACTAGTCATCGGGGAGTACGGCCCGCC
TCCAGATTTATGGCTTTAAGGTCACTAGTC|GTCATTCTGGGACAACTGCAGTGATTAATC
AGCATTCTCTCTACGAGATATAACAGAGCA|GGTACAGAGATATAACAGAGCACCGCGGAA
TTAGGTGCACCGCGTGTTTCCGGTGAGATA|GTAGCGCCAGTGCTCATATCCTGGGAGATA
TAACAGAGCACCGCGGAACGGGAGATATAA|ACGTATAAATGCTGGGCAAGCATGCGCGCA
TCCAAGCTGCGCTATAACATAGCGTAGCGC|CTCTTTTGATACGACTTAGAGTCGTTACGT
GCGGAACGGAATATGACACGATCAGCGTCG|CACCTCTGAGGAAATCCATCCACAGTAGTT
CGCGGAACGGAATGCAACAGTACCCACCGA|CTGAGCTACGATGGGCACGCGCCGGCCTTG
TATTTCCGGGAGATATAACAGAGCACCGCG|ACGGCCCGCCATCCTGCAACTGAGCGCTGA
CACCGCGGAACGGAATCGCGACCCCTTTGT|TCCGGGAGATATAACAGAGCACCGCGGAAC
CAAGTGAAATCAATTAGGTGATGTAGGGGG|GTCGGTTCGAGTCTCTGTGTTATGAGCATT
ATATAACAGAGCACCGCGGAACGGAATCGC|CACACTTTATTTCCGGGAGATATAACAGAG
AAATGCTGGGCAAGCATGCGCGCAGCTGTG|CGGAATAAGGGGTACAAATTCTGAGGAGTT
AACGGAATAAGGGGTACAAATTCTGAGGAG|GGCCATGAGTCTATTCGGATTGACGCAAGT
ATATAACAGAGCACCGCGGAACGGAATTCA|ATATAACAGAGCACCGCGGAACGGAATCCG
TGATTTTGTATTCTTCATGGCTGGCACCAT|GGAACGGAATGTGTTAGAGAGCATGGAGGA
GGAAACGGGAGATTTGACGGTCCCAAGAAT|ATTGATACCAGTAACACGGAATAAACGTCC
AACGGAATCGCGACCCCTTTGTTCACGTGT|ATATAACAGAGCACCGCGGAACGGAATGCA
GTCTATTCGGATTGACGCAAGTGAAATCAA|AATATGACACGATCAGCGTCGGTTCGAGTC
CTGCGCTATAACATAGCGTAGCGCCAGTGC|TGATACGACTTAGAGTCGTTACGTTTCCTA
TGACTGTGAACATATCCACCTCTGAGGAAA|GCGTGAGCAAAACAAGGAAACGGGAGATTT
AACAGAGCACCGCGGAACGGAATACCGCGG|TGTATTCTTCATGGCTGGCACCATGCCTGC
ACTTCAGCTTCACACTTTATTTCCGGGAGA|ACTAGTCATCGGGGAGTACGGCCCGCCATC
GATATAACAGAGCACCGCGGAACGGAATGT|TCTCTACGAGATATAACAGAGCACCGCGGA
AATCCGCCTTAACTAAGGATCAGTCCGATG|ACAGAGCACCGCGGAACGGGAGATATAACA
TGAGTCTATTCGGATTGACGCAAGTGAAAT|CGGAATATGACACGATCAGCGTCGGTTCGA
GGAACGGGAGATATAACAGAGCACCGCGGA|GGCAAGCATGCGCGCAGCTGTGAACGATTG
TCGGATTGACGCAAGTGAAATCAATTAGGT|ACACGATCAGCGTCGGTTCGAGTCTCTGTG
CACGATCAGCGTCGGTTCGAGTCTCTGTGT|CATCCACAGTAGTTGCATTACAGACGGGTT
AGCACCGCGGAACGGAATGCAACAGTACCC|GAGCGCTGAGCTACGATGGGCACGCGCCGG
GATTTATGGCTTTAAGGTCACTAGTCATCG|TTCTGGGACAACTGCAGTGATTAATCCGGT
TCAGCGTCGGTTCGAGTCTCTGTGTTATGA|ACAGTAGTTGCATTACAGACGGGTTTATTG
GATTGGATGGTCGGAGATATAACGAGATAT|TCCATATGCGGAGATATAACAGAGCACCGC
TCCACCTCTGAGGAAATCCATCCACAGTAG|AGGAAACGGGAGATTTGACGGTCCCAAGAA
CGCGGAACGGAATGTGTTAGAGAGCATGGA|ACAGAGCACCGCGGAACGGAATAACAAGTT
GGTCACTAGTCATCGGGGAGTACGGCCCGC|AGTGATTAATCCGGTCAATCTTTCTCCGTT
ACACTTCAGCTTCACACTTTATTTCCGGGA|TCACTAGTCATCGGGGAGTACGGCCCGCCA
CGCGGAACGGAATGATTTTGTATTCTTCAT|ACAGAGCACCGCGGAACGGAATGTGTTAGA
ACGCAAGTGAAATCAATTAGGTGATGTAGG|AGCGTCGGTTCGAGTCTCTGTGTTATGAGC
TGGTCGGAGATATAACGAGATATAACAGAG|GCGGAGATATAACAGAGCACCGCGGAACGG
GATGGTCGGAGATATAACGAGATATAACAG|ATGCGGAGATATAACAGAGCACCGCGGAAC
AACGGAATAATGTCTAGGGGAGATATAACA|GGATGGTCGGAGATATAACGAGATATAACA
TTTTGTATTCTTCATGGCTGGCACCATGCC|ACGGAATGTGTTAGAGAGCATGGAGGATTT
AGGCCACCATTCTGCTACGGCCATGAGTCT|AGATATAACAGAGCACCGCGGAACGGAATA
TAGGTGATGTAGGGGGAGATATAACAGAGC|CTGTGTTATGAGCATTCTCTCTACGAGATA
AGATATAACAGAGCACCGCGGAACGGAATA|CTGACTGTGAACATATCCACCTCTGAGGAA
GAGCAAAACAAGGAAACGGGAGATTTGACG|CCGAGTATTAGATTGATACCAGTAACACGG
CCAACACTTCAGCTTCACACTTTATTTCCG|AGGTCACTAGTCATCGGGGAGTACGGCCCG
TCACTGGAGATATAACAGAGCACCGCGGAA|CCGCCTTAACTAAGGATCAGTCCGATGCTC
GCCTGCTCAGGCCACCATTCTGCTACGGCC|TTTACGGGAGATATAACAGAGCACCGCGGA
AATGTCGCCGTGGTCGTTAGTCCAAGCTGC|AACTGGCACGTGTTGGCCCTCTCTTTTGAT
GTTATGGGGCGTGAGCAAAACAAGGAAACG|CAACAGTACCCACCGAGTATTAGATTGATA
TATAACAGAGCACCGCGGAACGGAATCGCG|ACACTTTATTTCCGGGAGATATAACAGAGC
GACCCCTTTGTTCACGTGTTATGGGGCGTG|CACCGCGGAACGGAATGCAACAGTACCCAC
TACCCACCGAGTATTAGATTGATACCAGTA|GCCGGCCTTGTACGAAAAGTAGCTTGGACA
CCGCGGAACGGGAGATATAACAGAGCACCG|GCTGGGCAAGCATGCGCGCAGCTGTGAACG
AGCTGCGCTATAACATAGCGTAGCGCCAGT|TTTGATACGACTTAGAGTCGTTACGTTTCC
CCTATACCAACACTTCAGCTTCACACTTTA|GCTTTAAGGTCACTAGTCATCGGGGAGTAC
GCACCGCGGAACGGAATGAAGGGGCTGGTG|GCGAGATATAACAGAGCACCGCGGAACGGA
CGGAACGGAATGCAACAGTACCCACCGAGT|GAGCTACGATGGGCACGCGCCGGCCTTGTA
CAGGACGGTATTTTTGAGATATAACAGAGC|CCGTACGGATCAAGTTGGCCTACGTATAAA
TGACACGATCAGCGTCGGTTCGAGTCTCTG|ATCCATCCACAGTAGTTGCATTACAGACGG
CCGCGGAACGGAATCGCGACCCCTTTGTTC|CGGGAGATATAACAGAGCACCGCGGAACGG
ACGGGAGATATAACAGAGCACCGCGGAACG|GTCTACTGACTGTGAACATATCCACCTCTG
ACGAGATATAACAGAGCACCGCGGAACGGA|TAACAGAGCACCGCGGAACGGAATCGCGAC
GAGATATAACAGAGCACCGCGGAACGGAAT|GAGATATAACAGAGCACCGCGGAACGGAAT
CCACAGTAGTTGCATTACAGACGGGTTTAT|TCCCAAGAATACAGTGGGCCCTATACCAAC
GACGCAAGTGAAATCAATTAGGTGATGTAG|CAGCGTCGGTTCGAGTCTCTGTGTTATGAG
CCGCGGAACGGAATAGAGCACCGCGGAACG|GCCTGCTCAGGCCACCATTCTGCTACGGCC
CAATTAGGTGATGTAGGGGGAGATATAACA|GTCTCTGTGTTATGAGCATTCTCTCTACGA
CGCGGAACGGAATACCGCGGAACGGAATAG|ATGGCTGGCACCATGCCTGCTCAGGCCACC
AGATATAACAGAGCACCGCGGAACGGGAGA|GGCCTACGTATAAATGCTGGGCAAGCATGC
CAAATTCTGAGGAGTTTATTCCATATGCGG|GGATTGACGCAAGTGAAATCAATTAGGTGA
GACTGTGAACATATCCACCTCTGAGGAAAT|CGTGAGCAAAACAAGGAAACGGGAGATTTG
GGTATTTTTGAGATATAACAGAGCACCGCG|GGATCAAGTTGGCCTACGTATAAATGCTGG
AGAATACAGTGGGCCCTATACCAACACTTC|CGTCCAGATTTATGGCTTTAAGGTCACTAG
TTGAGACAGTCTACTGACTGTGAACATATC|TCACGTGTTATGGGGCGTGAGCAAAACAAG
TGGCACGTGTTGGCCCTCTCTTTTGATACG|GGAACGGAATAATGTCTAGGGGAGATATAA
AGCACCGCGGAACGGAATCGCGACCCCTTT|TTTCCGGGAGATATAACAGAGCACCGCGGA
CGTGTTGGCCCTCTCTTTTGATACGACTTA|GGAATAATGTCTAGGGGAGATATAACAGAG
TAACAGAGCACCGCGGAACGGAATCGCGAC|ACTTTATTTCCGGGAGATATAACAGAGCAC
AACAGAGCACCGCGGAACGGAATCCGCCTT|GACGGTATTTTTGAGATATAACAGAGCACC
AAGTTGAGACAGTCTACTGACTGTGAACAT|TGTTCACGTGTTATGGGGCGTGAGCAAAAC
ATATAACAGAGCACCGCGGAACGGAATGAT|TAGGGGGAGATATAACAGAGCACCGCGGAA
ACGGGTTTATTGGTACAGAGATATAACAGA|CTATACCAACACTTCAGCTTCACACTTTAT
ACCGCGGAACGGAATAACAAGTTGAGACAG|ACGGAATCGCGACCCCTTTGTTCACGTGTT
CCAAGCTGCGCTATAACATAGCGTAGCGCC|TCTTTTGATACGACTTAGAGTCGTTACGTT
GTCGGAGATATAACGAGATATAACAGAGCG|GGAGATATAACAGAGCACCGCGGAACGGAA
TTACGGGAGATATAACAGAGCACCGCGGAA|CAGTCTACTGACTGTGAACATATCCACCTC
GGTGCAGGCCGTACGGATCAAGTTGGCCTA|CGGAATACCGCGGAACGGAATAGAGCACCG
GGGCTGGTGCAGGCCGTACGGATCAAGTTG|CGGAACGGAATACCGCGGAACGGAATAGAG
ATTGGTACAGAGATATAACAGAGCACCGCG|ACACTTCAGCTTCACACTTTATTTCCGGGA
GCGGAACGGAATAACAAGTTGAGACAGTCT|GAATCGCGACCCCTTTGTTCACGTGTTATG
ACATGCATTCCGCCAGGACGGTATTTTTGA|GGGCTGGTGCAGGCCGTACGGATCAAGTTG
CTGCTACGGCCATGAGTCTATTCGGATTGA|AGCACCGCGGAACGGAATATGACACGATCA
AGAGTCGTTACGTTTCCTATCACATGCATT|GCACCGCGGAACGGAATGAAGGGGCTGGTG
GGGCAAGCATGCGCGCAGCTGTGAACGATT|AGGGGTACAAATTCTGAGGAGTTTATTCCA
TCTTCATGGCTGGCACCATGCCTGCTCAGG|TGTTAGAGAGCATGGAGGATTTACGGGAGA
CGCGGAACGGAATCGCGACCCCTTTGTTCA|GGGAGATATAACAGAGCACCGCGGAACGGA
ATGGCTTTAAGGTCACTAGTCATCGGGGAG|GGACAACTGCAGTGATTAATCCGGTCAATC
CAGTGGGCCCTATACCAACACTTCAGCTTC|GATTTATGGCTTTAAGGTCACTAGTCATCG
CGCGGAACGGAATAACAAGTTGAGACAGTC|GGAATCGCGACCCCTTTGTTCACGTGTTAT
CGGAATACCGCGGAACGGAATAGAGCACCG|GCACCATGCCTGCTCAGGCCACCATTCTGC
GAGCACCGCGGAACGGAATAACAAGTTGAG|CGGAACGGAATCGCGACCCCTTTGTTCACG
GGGAGATTTGACGGTCCCAAGAATACAGTG|ACCAGTAACACGGAATAAACGTCCAGATTT
AGAGCACCGCGGAACGGAATGAAGGGGCTG|AGAGCGAGATATAACAGAGCACCGCGGAAC
GAGATATAACAGAGCACCGCGGAACGGAAT|ACTGACTGTGAACATATCCACCTCTGAGGA
GGAACGGAATAGAGCACCGCGGAACGGAAT|GCTCAGGCCACCATTCTGCTACGGCCATGA
CAGTACCCACCGAGTATTAGATTGATACCA|CGCGCCGGCCTTGTACGAAAAGTAGCTTGG
CGGTTCGAGTCTCTGTGTTATGAGCATTCT|TTGCATTACAGACGGGTTTATTGGTACAGA
CTTTATTTCCGGGAGATATAACAGAGCACC|AGTACGGCCCGCCATCCTGCAACTGAGCGC
ACCGCGGAACGGAATGAAGGGGCTGGTGCA|GAGATATAACAGAGCACCGCGGAACGGAAT
ATATCCTGGGAGATATAACAGAGCACCGCG|ACATGCATTCCGCCAGGACGGTATTTTTGA
ATGGTCGGAGATATAACGAGATATAACAGA|TGCGGAGATATAACAGAGCACCGCGGAACG
CAGAGCACCGCGGAACGGAATCGCGACCCC|TTATTTCCGGGAGATATAACAGAGCACCGC
CCTGGGAGATATAACAGAGCACCGCGGAAC|GCATTCCGCCAGGACGGTATTTTTGAGATA
ACCGCGGAACGGAATAATGTCTAGGGGAGA|AACGATTGGATGGTCGGAGATATAACGAGA
ACGTGTTATGGGGCGTGAGCAAAACAAGGA|AATGCAACAGTACCCACCGAGTATTAGATT
ATGACACGATCAGCGTCGGTTCGAGTCTCT|AATCCATCCACAGTAGTTGCATTACAGACG
GCTGGGCAAGCATGCGCGCAGCTGTGAACG|ATAAGGGGTACAAATTCTGAGGAGTTTATT
AGGCCGTACGGATCAAGTTGGCCTACGTAT|TACCGCGGAACGGAATAGAGCACCGCGGAA
AGTTGGCCTACGTATAAATGCTGGGCAAGC|TAGAGCACCGCGGAACGGAATAAGGGGTAC
GATCAAGTTGGCCTACGTATAAATGCTGGG|CGGAATAGAGCACCGCGGAACGGAATAAGG
CACCGCGGAACGGAATTCACTGGAGATATA|CACCGCGGAACGGAATCCGCCTTAACTAAG
AACAGAGCACCGCGGAACGGAATATGACAC|GTGAACATATCCACCTCTGAGGAAATCCAT
ACAGAGCACCGCGGAACGGAATACCGCGGA|GTATTCTTCATGGCTGGCACCATGCCTGCT
TAGGGGGAGATATAACAGAGCACCGCGGAA|GAGCATTCTCTCTACGAGATATAACAGAGC
TCGCGACCCCTTTGTTCACGTGTTATGGGG|AGAGCACCGCGGAACGGAATGCAACAGTAC
CCATGCCTGCTCAGGCCACCATTCTGCTAC|AGGATTTACGGGAGATATAACAGAGCACCG
ATTTATGGCTTTAAGGTCACTAGTCATCGG|TCTGGGACAACTGCAGTGATTAATCCGGTC
AGATATAACAGAGCACCGCGGAACGGAATC|CGCCAGGACGGTATTTTTGAGATATAACAG
GGAACGGAATACCGCGGAACGGAATAGAGC|GCTGGCACCATGCCTGCTCAGGCCACCATT
GAGCATTCTCTCTACGAGATATAACAGAGC|TGGTACAGAGATATAACAGAGCACCGCGGA
GGTACAAATTCTGAGGAGTTTATTCCATAT|ATTCGGATTGACGCAAGTGAAATCAATTAG
GGAATGCAACAGTACCCACCGAGTATTAGA|CGATGGGCACGCGCCGGCCTTGTACGAAAA
GATATAACAGAGCACCGCGGAACGGAATAA|GCGCGCAGCTGTGAACGATTGGATGGTCGG
TAACAGAGCACCGCGGAACGGAATGTCGCC|AGGATCAGTCCGATGCTCAGAAACTGGCAC
ATATAACAGAGCACCGCGGAACGGAATGTC|CTAAGGATCAGTCCGATGCTCAGAAACTGG
TTGACGCAAGTGAAATCAATTAGGTGATGT|ATCAGCGTCGGTTCGAGTCTCTGTGTTATG
CCGCGGAACGGAATCCGCCTTAACTAAGGA|TTTGAGATATAACAGAGCACCGCGGAACGG
GGTGATGTAGGGGGAGATATAACAGAGCAC|GTGTTATGAGCATTCTCTCTACGAGATATA
TTGATACGACTTAGAGTCGTTACGTTTCCT|AGATATAACAGAGCACCGCGGAACGGAATG
TGATACCAGTAACACGGAATAAACGTCCAG|TAGCTTGGACACACATGCTGTCTATGTCAT
AATGAAGGGGCTGGTGCAGGCCGTACGGAT|AGCACCGCGGAACGGAATACCGCGGAACGG
GGCGTGAGCAAAACAAGGAAACGGGAGATT|ACCCACCGAGTATTAGATTGATACCAGTAA
ACAGAGCACCGCGGAACGGGAGATATAACA|GTATAAATGCTGGGCAAGCATGCGCGCAGC
CAGTCTACTGACTGTGAACATATCCACCTC|GTTATGGGGCGTGAGCAAAACAAGGAAACG
ATATAACAGAGCACCGCGGAACGGGAGATA|CCTACGTATAAATGCTGGGCAAGCATGCGC
GCGAGATATAACAGAGCACCGCGGAACGGA|GAATGATTTTGTATTCTTCATGGCTGGCAC
CGGAATGTGTTAGAGAGCATGGAGGATTTA|ACCGCGGAACGGAATAACAAGTTGAGACAG
TAGTCCAAGCTGCGCTATAACATAGCGTAG|CCTCTCTTTTGATACGACTTAGAGTCGTTA
CATGCATTCCGCCAGGACGGTATTTTTGAG|GGCTGGTGCAGGCCGTACGGATCAAGTTGG
AGCTGTGAACGATTGGATGGTCGGAGATAT|AGGAGTTTATTCCATATGCGGAGATATAAC
ACGATCAGCGTCGGTTCGAGTCTCTGTGTT|ATCCACAGTAGTTGCATTACAGACGGGTTT
CGACCCCTTTGTTCACGTGTTATGGGGCGT|GCACCGCGGAACGGAATGCAACAGTACCCA
AAGTTGGCCTACGTATAAATGCTGGGCAAG|ATAGAGCACCGCGGAACGGAATAAGGGGTA
TCCATATGCGGAGATATAACAGAGCACCGC|CAATTAGGTGATGTAGGGGGAGATATAACA
TAACAGAGCACCGCGGAACGGAATAACAAG|CACCGCGGAACGGAATCGCGACCCCTTTGT
CCATTCTGCTACGGCCATGAGTCTATTCGG|AACAGAGCACCGCGGAACGGAATATGACAC
AACGGAATATGACACGATCAGCGTCGGTTC|TCTGAGGAAATCCATCCACAGTAGTTGCAT
CAGGCCGTACGGATCAAGTTGGCCTACGTA|ATACCGCGGAACGGAATAGAGCACCGCGGA
AGTACCCACCGAGTATTAGATTGATACCAG|GCGCCGGCCTTGTACGAAAAGTAGCTTGGA
TTTTTGAGATATAACAGAGCACCGCGGAAC|CAAGTTGGCCTACGTATAAATGCTGGGCAA
TATGGCTTTAAGGTCACTAGTCATCGGGGA|GGGACAACTGCAGTGATTAATCCGGTCAAT
CCCAAGAATACAGTGGGCCCTATACCAACA|TAAACGTCCAGATTTATGGCTTTAAGGTCA
GAGGAGTTTATTCCATATGCGGAGATATAA|GCAAGTGAAATCAATTAGGTGATGTAGGGG
TAACAGAGCACCGCGGAACGGAATAATGTC|GCAGCTGTGAACGATTGGATGGTCGGAGAT
TGTTGGCCCTCTCTTTTGATACGACTTAGA|AATAATGTCTAGGGGAGATATAACAGAGCA
CTGGGCAAGCATGCGCGCAGCTGTGAACGA|TAAGGGGTACAAATTCTGAGGAGTTTATTC
AACGGGAGATTTGACGGTCCCAAGAATACA|GATACCAGTAACACGGAATAAACGTCCAGA
CGATGCTCAGAAACTGGCACGTGTTGGCCC|TAACAGAGCACCGCGGAACGGAATAATGTC
GGAATGATTTTGTATTCTTCATGGCTGGCA|CCGCGGAACGGAATGTGTTAGAGAGCATGG
GGCTGGCACCATGCCTGCTCAGGCCACCAT|GAGCATGGAGGATTTACGGGAGATATAACA
ATTCTGCTACGGCCATGAGTCTATTCGGAT|CAGAGCACCGCGGAACGGAATATGACACGA
CCGGGAGATATAACAGAGCACCGCGGAACG|CCGCCATCCTGCAACTGAGCGCTGAGCTAC
TATCCTGGGAGATATAACAGAGCACCGCGG|CATGCATTCCGCCAGGACGGTATTTTTGAG
CCATCCACAGTAGTTGCATTACAGACGGGT|ACGGTCCCAAGAATACAGTGGGCCCTATAC
AGCACCGCGGAACGGAATCCGCCTTAACTA|TATTTTTGAGATATAACAGAGCACCGCGGA
ACGGATCAAGTTGGCCTACGTATAAATGCT|GAACGGAATAGAGCACCGCGGAACGGAATA
TAACAGAGCACCGCGGAACGGAATGCAACA|GCAACTGAGCGCTGAGCTACGATGGGCACG
ATCGCGACCCCTTTGTTCACGTGTTATGGG|CAGAGCACCGCGGAACGGAATGCAACAGTA
TGCAACAGTACCCACCGAGTATTAGATTGA|GGGCACGCGCCGGCCTTGTACGAAAAGTAG
ATATAACAGAGCACCGCGGAACGGAATATG|GACTGTGAACATATCCACCTCTGAGGAAAT
AGATATAACAGAGCACCGCGGAACGGAATA|TGCGCGCAGCTGTGAACGATTGGATGGTCG
ACAGTAGTTGCATTACAGACGGGTTTATTG|CCAAGAATACAGTGGGCCCTATACCAACAC
ATAACAGAGCACCGCGGAACGGAATCCGCC|AGGACGGTATTTTTGAGATATAACAGAGCA
AATGTCTAGGGGAGATATAACAGAGCACCG|GGAGATATAACGAGATATAACAGAGCGAGA
CCGCGGAACGGAATGCAACAGTACCCACCG|GCTGAGCTACGATGGGCACGCGCCGGCCTT
TTATGGCTTTAAGGTCACTAGTCATCGGGG|TGGGACAACTGCAGTGATTAATCCGGTCAA
AGACAGTCTACTGACTGTGAACATATCCAC|CGTGTTATGGGGCGTGAGCAAAACAAGGAA
CCCCTTTGTTCACGTGTTATGGGGCGTGAG|CCGCGGAACGGAATGCAACAGTACCCACCG
ACCGCGGAACGGAATCCGCCTTAACTAAGG|TTTTGAGATATAACAGAGCACCGCGGAACG
TCTATTCGGATTGACGCAAGTGAAATCAAT|ATATGACACGATCAGCGTCGGTTCGAGTCT
GGAATAGAGCACCGCGGAACGGAATAAGGG|GGCCACCATTCTGCTACGGCCATGAGTCTA
TATAACAGAGCACCGCGGAACGGAATGTGT|TCTACGAGATATAACAGAGCACCGCGGAAC
GAGCACCGCGGAACGGAATAAGGGGTACAA|CATTCTGCTACGGCCATGAGTCTATTCGGA
GAACGGAATACCGCGGAACGGAATAGAGCA|CTGGCACCATGCCTGCTCAGGCCACCATTC
GATTTGACGGTCCCAAGAATACAGTGGGCC|GTAACACGGAATAAACGTCCAGATTTATGG
ATTTTGTATTCTTCATGGCTGGCACCATGC|AACGGAATGTGTTAGAGAGCATGGAGGATT
GAGTCGTTACGTTTCCTATCACATGCATTC|CACCGCGGAACGGAATGAAGGGGCTGGTGC
ACCAGTAACACGGAATAAACGTCCAGATTT|TTGGACACACATGCTGTCTATGTCATTCTG
GCACCGCGGAACGGAATTCACTGGAGATAT|GCACCGCGGAACGGAATCCGCCTTAACTAA
ATAAATGCTGGGCAAGCATGCGCGCAGCTG|AACGGAATAAGGGGTACAAATTCTGAGGAG
ACGGGAGATATAACAGAGCACCGCGGAACG|AAGCATGCGCGCAGCTGTGAACGATTGGAT
TGAAGGGGCTGGTGCAGGCCGTACGGATCA|CACCGCGGAACGGAATACCGCGGAACGGAA
ATCAGTCCGATGCTCAGAAACTGGCACGTG|GGAGATATAACAGAGCACCGCGGAACGGAA
AGTAACACGGAATAAACGTCCAGATTTATG|GACACACATGCTGTCTATGTCATTCTGGGA
GGAACGGAATTCACTGGAGATATAACAGAG|GGAACGGAATCCGCCTTAACTAAGGATCAG
GATCAGTCCGATGCTCAGAAACTGGCACGT|GGGAGATATAACAGAGCACCGCGGAACGGA
CACTTCAGCTTCACACTTTATTTCCGGGAG|CACTAGTCATCGGGGAGTACGGCCCGCCAT
AATAAGGGGTACAAATTCTGAGGAGTTTAT|TGAGTCTATTCGGATTGACGCAAGTGAAAT
ATTGGATGGTCGGAGATATAACGAGATATA|CCATATGCGGAGATATAACAGAGCACCGCG
AGAGCACCGCGGAACGGAATCCGCCTTAAC|GGTATTTTTGAGATATAACAGAGCACCGCG
GCGTGAGCAAAACAAGGAAACGGGAGATTT|CCCACCGAGTATTAGATTGATACCAGTAAC
ACTGACTGTGAACATATCCACCTCTGAGGA|GGGCGTGAGCAAAACAAGGAAACGGGAGAT
ATTTCCGGGAGATATAACAGAGCACCGCGG|CGGCCCGCCATCCTGCAACTGAGCGCTGAG
TAACATAGCGTAGCGCCAGTGCTCATATCC|CTTAGAGTCGTTACGTTTCCTATCACATGC
AGCACCGCGGAACGGAATAACAAGTTGAGA|GGAACGGAATCGCGACCCCTTTGTTCACGT
GAGTACGGCCCGCCATCCTGCAACTGAGCG|ATCTTTCTCCGTTCTTGTTAAGGTCAGGGC
GAGATATAACGAGATATAACAGAGCGAGAT|ATATAACAGAGCACCGCGGAACGGAATGAT
CAGAGCACCGCGGAACGGAATATGACACGA|GAACATATCCACCTCTGAGGAAATCCATCC
CGCCAGGACGGTATTTTTGAGATATAACAG|AGGCCGTACGGATCAAGTTGGCCTACGTAT
GCCAGGACGGTATTTTTGAGATATAACAGA|GGCCGTACGGATCAAGTTGGCCTACGTATA
ATATAACGAGATATAACAGAGCGAGATATA|TAACAGAGCACCGCGGAACGGAATGATTTT
AAGGGGTACAAATTCTGAGGAGTTTATTCC|GTCTATTCGGATTGACGCAAGTGAAATCAA
TGGGGCGTGAGCAAAACAAGGAAACGGGAG|AGTACCCACCGAGTATTAGATTGATACCAG
GAATGAAGGGGCTGGTGCAGGCCGTACGGA|GAGCACCGCGGAACGGAATACCGCGGAACG
CTAGGGGAGATATAACAGAGCACCGCGGAA|TATAACGAGATATAACAGAGCGAGATATAA
CCGCGGAACGGAATGTGTTAGAGAGCATGG|AACAGAGCACCGCGGAACGGAATAACAAGT
AGATATAACAGAGCACCGCGGAACGGAATG|CTCTCTACGAGATATAACAGAGCACCGCGG
GGTTTATTGGTACAGAGATATAACAGAGCA|TACCAACACTTCAGCTTCACACTTTATTTC
CGAGATATAACAGAGCGAGATATAACAGAG|AGCACCGCGGAACGGAATGATTTTGTATTC
CGTGGTCGTTAGTCCAAGCTGCGCTATAAC|CGTGTTGGCCCTCTCTTTTGATACGACTTA
CTGCTCAGGCCACCATTCTGCTACGGCCAT|TACGGGAGATATAACAGAGCACCGCGGAAC
GGAACGGAATGAAGGGGCTGGTGCAGGCCG|ATAACAGAGCACCGCGGAACGGAATACCGC
GAGCACCGCGGAACGGAATGATTTTGTATT|GATATAACAGAGCACCGCGGAACGGAATGT
TCACGTGTTATGGGGCGTGAGCAAAACAAG|GGAATGCAACAGTACCCACCGAGTATTAGA
GCAACAGTACCCACCGAGTATTAGATTGAT|GGCACGCGCCGGCCTTGTACGAAAAGTAGC
GAGCACCGCGGAACGGGAGATATAACAGAG|TAAATGCTGGGCAAGCATGCGCGCAGCTGT
TCTGAGGAAATCCATCCACAGTAGTTGCAT|CGGGAGATTTGACGGTCCCAAGAATACAGT
GCGGAACGGAATAGAGCACCGCGGAACGGA|CTGCTCAGGCCACCATTCTGCTACGGCCAT
TTTGACGGTCCCAAGAATACAGTGGGCCCT|AACACGGAATAAACGTCCAGATTTATGGCT
TTCCGGGAGATATAACAGAGCACCGCGGAA|GCCCGCCATCCTGCAACTGAGCGCTGAGCT
GTTGGCCCTCTCTTTTGATACGACTTAGAG|ATAATGTCTAGGGGAGATATAACAGAGCAC
AAACTGGCACGTGTTGGCCCTCTCTTTTGA|CCGCGGAACGGAATAATGTCTAGGGGAGAT
GAATTCACTGGAGATATAACAGAGCACCGC|GAATCCGCCTTAACTAAGGATCAGTCCGAT
CTCTCTTTTGATACGACTTAGAGTCGTTAC|CTAGGGGAGATATAACAGAGCACCGCGGAA
GCACCGCGGAACGGAATGATTTTGTATTCT|TATAACAGAGCACCGCGGAACGGAATGTGT
TCTACGAGATATAACAGAGCACCGCGGAAC|ATATAACAGAGCACCGCGGAACGGAATCGC
ATAACAGAGCACCGCGGAACGGAATATGAC|CTGTGAACATATCCACCTCTGAGGAAATCC
CTATCACATGCATTCCGCCAGGACGGTATT|TGAAGGGGCTGGTGCAGGCCGTACGGATCA
AGGAAATCCATCCACAGTAGTTGCATTACA|AGATTTGACGGTCCCAAGAATACAGTGGGC
ACCGCGGAACGGAATTCACTGGAGATATAA|ACCGCGGAACGGAATCCGCCTTAACTAAGG
ACTAGTCATCGGGGAGTACGGCCCGCCATC|ATTAATCCGGTCAATCTTTCTCCGTTCTTG
GGGGCTGGTGCAGGCCGTACGGATCAAGTT|GCGGAACGGAATACCGCGGAACGGAATAGA
AGAGAGCATGGAGGATTTACGGGAGATATA|GAATAACAAGTTGAGACAGTCTACTGACTG
GTATAAATGCTGGGCAAGCATGCGCGCAGC|GGAACGGAATAAGGGGTACAAATTCTGAGG
AAGCATGCGCGCAGCTGTGAACGATTGGAT|GTACAAATTCTGAGGAGTTTATTCCATATG
AACGGAATAACAAGTTGAGACAGTCTACTG|CGCGACCCCTTTGTTCACGTGTTATGGGGC
GGAATCGCGACCCCTTTGTTCACGTGTTAT|TAACAGAGCACCGCGGAACGGAATGCAACA
GAATACAGTGGGCCCTATACCAACACTTCA|GTCCAGATTTATGGCTTTAAGGTCACTAGT
ATGTCGCCGTGGTCGTTAGTCCAAGCTGCG|ACTGGCACGTGTTGGCCCTCTCTTTTGATA
ACGGTATTTTTGAGATATAACAGAGCACCG|ACGGATCAAGTTGGCCTACGTATAAATGCT
TGTTTCCGGTGAGATATAACAGAGCACCGC|CATATCCTGGGAGATATAACAGAGCACCGC
TTCCTATCACATGCATTCCGCCAGGACGGT|GAATGAAGGGGCTGGTGCAGGCCGTACGGA
TAACACGGAATAAACGTCCAGATTTATGGC|CACACATGCTGTCTATGTCATTCTGGGACA
ACCCACCGAGTATTAGATTGATACCAGTAA|CCGGCCTTGTACGAAAAGTAGCTTGGACAC
AACACGGAATAAACGTCCAGATTTATGGCT|ACACATGCTGTCTATGTCATTCTGGGACAA
AGCACCGCGGAACGGAATAATGTCTAGGGG|GTGAACGATTGGATGGTCGGAGATATAACG
AACAGTACCCACCGAGTATTAGATTGATAC|CACGCGCCGGCCTTGTACGAAAAGTAGCTT
GGATCAGTCCGATGCTCAGAAACTGGCACG|CGGGAGATATAACAGAGCACCGCGGAACGG
CGCGGAACGGAATCCGCCTTAACTAAGGAT|TTGAGATATAACAGAGCACCGCGGAACGGG
TCACTAGTCATCGGGGAGTACGGCCCGCCA|TGATTAATCCGGTCAATCTTTCTCCGTTCT
ACAGAGCACCGCGGAACGGAATGCAACAGT|AACTGAGCGCTGAGCTACGATGGGCACGCG
TTAACTAAGGATCAGTCCGATGCTCAGAAA|CCGCGGAACGGGAGATATAACAGAGCACCG
ATCCACCTCTGAGGAAATCCATCCACAGTA|AAGGAAACGGGAGATTTGACGGTCCCAAGA
TTTCCTATCACATGCATTCCGCCAGGACGG|GGAATGAAGGGGCTGGTGCAGGCCGTACGG
CAAGTTGAGACAGTCTACTGACTGTGAACA|TTGTTCACGTGTTATGGGGCGTGAGCAAAA
AGATATAACAGAGCACCGCGGAACGGAATA|CAGAGCACCGCGGAACGGAATCGCGACCCC
AACGATTGGATGGTCGGAGATATAACGAGA|TATTCCATATGCGGAGATATAACAGAGCAC
AGACGGGTTTATTGGTACAGAGATATAACA|CCCTATACCAACACTTCAGCTTCACACTTT
GTATTAGATTGATACCAGTAACACGGAATA|TACGAAAAGTAGCTTGGACACACATGCTGT
CTCAGAAACTGGCACGTGTTGGCCCTCTCT|GAGCACCGCGGAACGGAATAATGTCTAGGG
TCATGGCTGGCACCATGCCTGCTCAGGCCA|TAGAGAGCATGGAGGATTTACGGGAGATAT
ATCCGCCTTAACTAAGGATCAGTCCGATGC|CAGAGCACCGCGGAACGGGAGATATAACAG
GTACCCACCGAGTATTAGATTGATACCAGT|CGCCGGCCTTGTACGAAAAGTAGCTTGGAC
TCTCTGTGTTATGAGCATTCTCTCTACGAG|AGACGGGTTTATTGGTACAGAGATATAACA
GTGATGTAGGGGGAGATATAACAGAGCACC|TGTTATGAGCATTCTCTCTACGAGATATAA
TTTACGGGAGATATAACAGAGCACCGCGGA|ACAGTCTACTGACTGTGAACATATCCACCT
CAGGCCACCATTCTGCTACGGCCATGAGTC|GAGATATAACAGAGCACCGCGGAACGGAAT
TTAGGTGATGTAGGGGGAGATATAACAGAG|TCTGTGTTATGAGCATTCTCTCTACGAGAT
GGATGGTCGGAGATATAACGAGATATAACA|TATGCGGAGATATAACAGAGCACCGCGGAA
CTTCATGGCTGGCACCATGCCTGCTCAGGC|GTTAGAGAGCATGGAGGATTTACGGGAGAT
TCCGGGAGATATAACAGAGCACCGCGGAAC|CCCGCCATCCTGCAACTGAGCGCTGAGCTA
TACAGACGGGTTTATTGGTACAGAGATATA|GGGCCCTATACCAACACTTCAGCTTCACAC
TTACAGACGGGTTTATTGGTACAGAGATAT|TGGGCCCTATACCAACACTTCAGCTTCACA
TACTGACTGTGAACATATCCACCTCTGAGG|GGGGCGTGAGCAAAACAAGGAAACGGGAGA
TCGGGGAGTACGGCCCGCCATCCTGCAACT|GGTCAATCTTTCTCCGTTCTTGTTAAGGTC
GGGTTTATTGGTACAGAGATATAACAGAGC|ATACCAACACTTCAGCTTCACACTTTATTT
CACGGAATAAACGTCCAGATTTATGGCTTT|ACATGCTGTCTATGTCATTCTGGGACAACT
TTATGTTAGGTGCACCGCGTGTTTCCGGTG|ATAGCGTAGCGCCAGTGCTCATATCCTGGG
TATGTTAGGTGCACCGCGTGTTTCCGGTGA|TAGCGTAGCGCCAGTGCTCATATCCTGGGA
CACCATTCTGCTACGGCCATGAGTCTATTC|ATAACAGAGCACCGCGGAACGGAATATGAC
GATATAACAGAGCACCGCGGAACGGAATCG|TCACACTTTATTTCCGGGAGATATAACAGA
TACCAGTAACACGGAATAAACGTCCAGATT|CTTGGACACACATGCTGTCTATGTCATTCT
CCAAGAATACAGTGGGCCCTATACCAACAC|AAACGTCCAGATTTATGGCTTTAAGGTCAC
ATAACAGAGCACCGCGGAACGGAATTCACT|ATAACAGAGCACCGCGGAACGGAATCCGCC
TATAACAGAGCACCGCGGAACGGAATTCAC|TATAACAGAGCACCGCGGAACGGAATCCGC
CAAAACAAGGAAACGGGAGATTTGACGGTC|AGTATTAGATTGATACCAGTAACACGGAAT
GAATGATTTTGTATTCTTCATGGCTGGCAC|CGCGGAACGGAATGTGTTAGAGAGCATGGA
GAAACTGGCACGTGTTGGCCCTCTCTTTTG|ACCGCGGAACGGAATAATGTCTAGGGGAGA
ACTGGAGATATAACAGAGCACCGCGGAACG|GCCTTAACTAAGGATCAGTCCGATGCTCAG
CGGGGAGTACGGCCCGCCATCCTGCAACTG|GTCAATCTTTCTCCGTTCTTGTTAAGGTCA
AGAGCACCGCGGAACGGAATACCGCGGAAC|ATTCTTCATGGCTGGCACCATGCCTGCTCA
CAAGAATACAGTGGGCCCTATACCAACACT|AACGTCCAGATTTATGGCTTTAAGGTCACT
CCGCCTTAACTAAGGATCAGTCCGATGCTC|GAGCACCGCGGAACGGGAGATATAACAGAG
AAGGGGCTGGTGCAGGCCGTACGGATCAAG|CCGCGGAACGGAATACCGCGGAACGGAATA
ATGAGCATTCTCTCTACGAGATATAACAGA|ATTGGTACAGAGATATAACAGAGCACCGCG
CAGAAACTGGCACGTGTTGGCCCTCTCTTT|GCACCGCGGAACGGAATAATGTCTAGGGGA
TGTTATGAGCATTCTCTCTACGAGATATAA|GTTTATTGGTACAGAGATATAACAGAGCAC
GCCTTAACTAAGGATCAGTCCGATGCTCAG|GCACCGCGGAACGGGAGATATAACAGAGCA
GTTCACGTGTTATGGGGCGTGAGCAAAACA|ACGGAATGCAACAGTACCCACCGAGTATTA
ATAACAGAGCACCGCGGAACGGAATCGCGA|CACTTTATTTCCGGGAGATATAACAGAGCA
CAGAGCACCGCGGAACGGGAGATATAACAG|TATAAATGCTGGGCAAGCATGCGCGCAGCT
ACTTTATTTCCGGGAGATATAACAGAGCAC|GAGTACGGCCCGCCATCCTGCAACTGAGCG
GAATACCGCGGAACGGAATAGAGCACCGCG|ACCATGCCTGCTCAGGCCACCATTCTGCTA
GGGAGATATAACAGAGCACCGCGGAACGGA|CTACTGACTGTGAACATATCCACCTCTGAG
TTTATTGGTACAGAGATATAACAGAGCACC|CCAACACTTCAGCTTCACACTTTATTTCCG
TTGGCCCTCTCTTTTGATACGACTTAGAGT|TAATGTCTAGGGGAGATATAACAGAGCACC
AGCACCGCGGAACGGAATGTCGCCGTGGTC|AGTCCGATGCTCAGAAACTGGCACGTGTTG
GAACGGAATAAGGGGTACAAATTCTGAGGA|CGGCCATGAGTCTATTCGGATTGACGCAAG
ACAGAGCACCGCGGAACGGAATAACAAGTT|CCGCGGAACGGAATCGCGACCCCTTTGTTC
GGAACGGAATAATGTCTAGGGGAGATATAA|TTGGATGGTCGGAGATATAACGAGATATAA
ACGGCCATGAGTCTATTCGGATTGACGCAA|CGCGGAACGGAATATGACACGATCAGCGTC
CCTCTGAGGAAATCCATCCACAGTAGTTGC|AACGGGAGATTTGACGGTCCCAAGAATACA
TCAGCTTCACACTTTATTTCCGGGAGATAT|AGTCATCGGGGAGTACGGCCCGCCATCCTG
AATATGACACGATCAGCGTCGGTTCGAGTC|GGAAATCCATCCACAGTAGTTGCATTACAG
CTGGGAGATATAACAGAGCACCGCGGAACG|CATTCCGCCAGGACGGTATTTTTGAGATAT
GTAACACGGAATAAACGTCCAGATTTATGG|ACACACATGCTGTCTATGTCATTCTGGGAC
GCGCAGCTGTGAACGATTGGATGGTCGGAG|TCTGAGGAGTTTATTCCATATGCGGAGATA
TGCTACGGCCATGAGTCTATTCGGATTGAC|GCACCGCGGAACGGAATATGACACGATCAG
CCAGTAACACGGAATAAACGTCCAGATTTA|TGGACACACATGCTGTCTATGTCATTCTGG
GAGATATAACAGAGCACCGCGGAACGGAAT|CTTCACACTTTATTTCCGGGAGATATAACA
TAGCGTAGCGCCAGTGCTCATATCCTGGGA|AGTCGTTACGTTTCCTATCACATGCATTCC
TCTGCTACGGCCATGAGTCTATTCGGATTG|GAGCACCGCGGAACGGAATATGACACGATC
GCTACGGCCATGAGTCTATTCGGATTGACG|CACCGCGGAACGGAATATGACACGATCAGC
ACATATCCACCTCTGAGGAAATCCATCCAC|AAACAAGGAAACGGGAGATTTGACGGTCCC
TATAACAGAGCACCGCGGAACGGAATGAAG|TATAACAGAGCGAGATATAACAGAGCACCG
CTTTTGATACGACTTAGAGTCGTTACGTTT|GGGAGATATAACAGAGCACCGCGGAACGGA
GAACGGAATAACAAGTTGAGACAGTCTACT|TCGCGACCCCTTTGTTCACGTGTTATGGGG
ATACGACTTAGAGTCGTTACGTTTCCTATC|TATAACAGAGCACCGCGGAACGGAATGAAG
TGACGGTCCCAAGAATACAGTGGGCCCTAT|CACGGAATAAACGTCCAGATTTATGGCTTT
AAATCAATTAGGTGATGTAGGGGGAGATAT|TCGAGTCTCTGTGTTATGAGCATTCTCTCT
GGAATACCGCGGAACGGAATAGAGCACCGC|CACCATGCCTGCTCAGGCCACCATTCTGCT
ACAGTCTACTGACTGTGAACATATCCACCT|TGTTATGGGGCGTGAGCAAAACAAGGAAAC
TGTTAGGTGCACCGCGTGTTTCCGGTGAGA|GCGTAGCGCCAGTGCTCATATCCTGGGAGA
TAACAGAGCACCGCGGAACGGAATATGACA|TGTGAACATATCCACCTCTGAGGAAATCCA
GGGGAGATATAACAGAGCACCGCGGAACGG|AACGAGATATAACAGAGCGAGATATAACAG
AGAGCACCGCGGAACGGAATTCACTGGAGA|AGAGCACCGCGGAACGGAATCCGCCTTAAC
TTATGAGCATTCTCTCTACGAGATATAACA|TTATTGGTACAGAGATATAACAGAGCACCG
ACAGTGGGCCCTATACCAACACTTCAGCTT|AGATTTATGGCTTTAAGGTCACTAGTCATC
GCATGGAGGATTTACGGGAGATATAACAGA|ACAAGTTGAGACAGTCTACTGACTGTGAAC
GATATAACAGAGCACCGCGGAACGGAATGT|ACTAAGGATCAGTCCGATGCTCAGAAACTG
TGTTATGGGGCGTGAGCAAAACAAGGAAAC|GCAACAGTACCCACCGAGTATTAGATTGAT
CACCGCGGAACGGAATGCAACAGTACCCAC|GCGCTGAGCTACGATGGGCACGCGCCGGCC
ATCCATCCACAGTAGTTGCATTACAGACGG|TGACGGTCCCAAGAATACAGTGGGCCCTAT
CATATGCGGAGATATAACAGAGCACCGCGG|ATTAGGTGATGTAGGGGGAGATATAACAGA
GCTCAGAAACTGGCACGTGTTGGCCCTCTC|AGAGCACCGCGGAACGGAATAATGTCTAGG
CCGCGGAACGGAATAAGGGGTACAAATTCT|TGCTACGGCCATGAGTCTATTCGGATTGAC
GCACCGCGGAACGGAATATGACACGATCAG|ATATCCACCTCTGAGGAAATCCATCCACAG
GTACAGAGATATAACAGAGCACCGCGGAAC|TTCAGCTTCACACTTTATTTCCGGGAGATA
CACCGCGGAACGGAATGATTTTGTATTCTT|ATAACAGAGCACCGCGGAACGGAATGTGTT
TTGACGGTCCCAAGAATACAGTGGGCCCTA|ACACGGAATAAACGTCCAGATTTATGGCTT
GTGCACCGCGTGTTTCCGGTGAGATATAAC|CGCCAGTGCTCATATCCTGGGAGATATAAC
AACGGAATCCGCCTTAACTAAGGATCAGTC|ATATAACAGAGCACCGCGGAACGGGAGATA
GAGCACCGCGGAACGGAATCCGCCTTAACT|GTATTTTTGAGATATAACAGAGCACCGCGG
TAACAGAGCACCGCGGAACGGAATTCACTG|TAACAGAGCACCGCGGAACGGAATCCGCCT
TGCTGGGCAAGCATGCGCGCAGCTGTGAAC|AATAAGGGGTACAAATTCTGAGGAGTTTAT
GCCGTACGGATCAAGTTGGCCTACGTATAA|CCGCGGAACGGAATAGAGCACCGCGGAACG
CAAGGAAACGGGAGATTTGACGGTCCCAAG|TAGATTGATACCAGTAACACGGAATAAACG
AACGTCCAGATTTATGGCTTTAAGGTCACT|CTATGTCATTCTGGGACAACTGCAGTGATT
ATGCTGGGCAAGCATGCGCGCAGCTGTGAA|GAATAAGGGGTACAAATTCTGAGGAGTTTA
ACAAATTCTGAGGAGTTTATTCCATATGCG|CGGATTGACGCAAGTGAAATCAATTAGGTG
CACCGAGTATTAGATTGATACCAGTAACAC|GCCTTGTACGAAAAGTAGCTTGGACACACA
CGCGGAACGGAATAAGGGGTACAAATTCTG|GCTACGGCCATGAGTCTATTCGGATTGACG
GCGGAGATATAACAGAGCACCGCGGAACGG|GTGATGTAGGGGGAGATATAACAGAGCACC
ACCGCGGAACGGAATAAGGGGTACAAATTC|CTGCTACGGCCATGAGTCTATTCGGATTGA
CTATAACATAGCGTAGCGCCAGTGCTCATA|CGACTTAGAGTCGTTACGTTTCCTATCACA
GAACGGAATGATTTTGTATTCTTCATGGCT|AGCACCGCGGAACGGAATGTGTTAGAGAGC
CTTCAGCTTCACACTTTATTTCCGGGAGAT|CTAGTCATCGGGGAGTACGGCCCGCCATCC
TACGTTTCCTATCACATGCATTCCGCCAGG|GAACGGAATGAAGGGGCTGGTGCAGGCCGT
CCGCGGAACGGAATGAAGGGGCTGGTGCAG|AGATATAACAGAGCACCGCGGAACGGAATA
ACAGAGCACCGCGGAACGGAATAATGTCTA|AGCTGTGAACGATTGGATGGTCGGAGATAT
CAGAGCACCGCGGAACGGAATTCACTGGAG|CAGAGCACCGCGGAACGGAATCCGCCTTAA
TAACAGAGCACCGCGGAACGGAATCCGCCT|GGACGGTATTTTTGAGATATAACAGAGCAC
TTGTATTCTTCATGGCTGGCACCATGCCTG|GGAATGTGTTAGAGAGCATGGAGGATTTAC
GTGAACGATTGGATGGTCGGAGATATAACG|GTTTATTCCATATGCGGAGATATAACAGAG
ATTCTTCATGGCTGGCACCATGCCTGCTCA|TGTGTTAGAGAGCATGGAGGATTTACGGGA
CTACGTATAAATGCTGGGCAAGCATGCGCG|CCGCGGAACGGAATAAGGGGTACAAATTCT
GCGCTATAACATAGCGTAGCGCCAGTGCTC|ATACGACTTAGAGTCGTTACGTTTCCTATC
CGGAACGGAATAACAAGTTGAGACAGTCTA|AATCGCGACCCCTTTGTTCACGTGTTATGG
TGATACGACTTAGAGTCGTTACGTTTCCTA|GATATAACAGAGCACCGCGGAACGGAATGA
GAACGGAATGAAGGGGCTGGTGCAGGCCGT|TAACAGAGCACCGCGGAACGGAATACCGCG
ATATAACAGAGCACCGCGGAACGGAATCCG|CCAGGACGGTATTTTTGAGATATAACAGAG
CTGTGTTATGAGCATTCTCTCTACGAGATA|CGGGTTTATTGGTACAGAGATATAACAGAG
GGAGATATAACAGAGCACCGCGGAACGGAA|TTAACTAAGGATCAGTCCGATGCTCAGAAA
GGAATGAAGGGGCTGGTGCAGGCCGTACGG|AGAGCACCGCGGAACGGAATACCGCGGAAC
TGGCCCTCTCTTTTGATACGACTTAGAGTC|AATGTCTAGGGGAGATATAACAGAGCACCG
AACAGAGCACCGCGGAACGGAATGTGTTAG|ACGAGATATAACAGAGCACCGCGGAACGGA
CCAGGACGGTATTTTTGAGATATAACAGAG|GCCGTACGGATCAAGTTGGCCTACGTATAA
AGGGGTACAAATTCTGAGGAGTTTATTCCA|TCTATTCGGATTGACGCAAGTGAAATCAAT
CGGAATAACAAGTTGAGACAGTCTACTGAC|CGACCCCTTTGTTCACGTGTTATGGGGCGT
CGGAATATGACACGATCAGCGTCGGTTCGA|TGAGGAAATCCATCCACAGTAGTTGCATTA
AGGTCACTAGTCATCGGGGAGTACGGCCCG|CAGTGATTAATCCGGTCAATCTTTCTCCGT
ACCGCGGAACGGAATAGAGCACCGCGGAAC|TGCCTGCTCAGGCCACCATTCTGCTACGGC
GTATTTTTGAGATATAACAGAGCACCGCGG|GATCAAGTTGGCCTACGTATAAATGCTGGG
GAAGGGGCTGGTGCAGGCCGTACGGATCAA|ACCGCGGAACGGAATACCGCGGAACGGAAT
GGAGATATAACAGAGCACCGCGGAACGGAA|CATGCGCGCAGCTGTGAACGATTGGATGGT
GGATCAAGTTGGCCTACGTATAAATGCTGG|ACGGAATAGAGCACCGCGGAACGGAATAAG
GACGGTCCCAAGAATACAGTGGGCCCTATA|ACGGAATAAACGTCCAGATTTATGGCTTTA
ATATAACAGAGCACCGCGGAACGGAATACC|ATTTTGTATTCTTCATGGCTGGCACCATGC
ATCGGGGAGTACGGCCCGCCATCCTGCAAC|CGGTCAATCTTTCTCCGTTCTTGTTAAGGT
