TTAGCGATATATATCGCGT -> TAGCGATATATATCGCGTT
TTGCTAATACCTGTTGTGT -> TGCTAATACCTGTTGTGTA
AATATGTGTAGGTCTTGGA -> ATATGTGTAGGTCTTGGAT
GGAACATCACAGCGTCATA -> GAACATCACAGCGTCATAT
TGGTGGGACCCACTTGCAT -> GGTGGGACCCACTTGCATC
ATCTGAACATCGGGCGTAC -> TCTGAACATCGGGCGTACT
TCTGAACATCGGGCGTACT -> CTGAACATCGGGCGTACTC
AAAAGGGAACACTCCGCCC -> AAAGGGAACACTCCGCCCC
TTAGAGGTCCTAACCAGGA -> TAGAGGTCCTAACCAGGAT
TGCGTGGTACAATTTAATT -> GCGTGGTACAATTTAATTT
AGGTTCAGTAGAGCGGAAA -> GGTTCAGTAGAGCGGAAAA
GAGGACCAAGAACCGTGCG -> AGGACCAAGAACCGTGCGA
GCGCGCGTAGTGACACGCA -> CGCGCGTAGTGACACGCAA
GAGGTCCTAACCAGGATGC -> AGGTCCTAACCAGGATGCA
AAAGAAGCTCCAGACCTGG -> AAGAAGCTCCAGACCTGGA
GCGGTTAGAAATTTTAAGT -> CGGTTAGAAATTTTAAGTC
CATCGGGCGTACTCTCCTT -> ATCGGGCGTACTCTCCTTC
TGCATGTTGTTGACTCGTT -> GCATGTTGTTGACTCGTTC
TAGCTCGTGTGGACCCGAC -> AGCTCGTGTGGACCCGACC
GCGAGTGCCGCAATATGTG -> CGAGTGCCGCAATATGTGT
TATACTCGCGGCCCAAACC -> ATACTCGCGGCCCAAACCG
TCTGGGAGGGGAGAACCTA -> CTGGGAGGGGAGAACCTAC
AATCACTGCACTATACTCG -> ATCACTGCACTATACTCGC
TCCCGAAAACTACTGTCAG -> CCCGAAAACTACTGTCAGG
TGAGGTCTGGGAGGGGAGA -> GAGGTCTGGGAGGGGAGAA
TTACTTTCAACGGCCACTG -> TACTTTCAACGGCCACTGC
GACTCAGTAATACCGCACA -> ACTCAGTAATACCGCACAC
TAGTTCCTTGCTACTGGGG -> AGTTCCTTGCTACTGGGGG
TGTGATCCCGTTCTAGTAT -> GTGATCCCGTTCTAGTATC
GCATCCAGCGGCGATATAA -> CATCCAGCGGCGATATAAG
CTTGGATCACAACGTTCTA -> TTGGATCACAACGTTCTAA
TGAAAGAAGTTCTTAGCTC -> GAAAGAAGTTCTTAGCTCG
TGTTACAACCCACCTAAGA -> GTTACAACCCACCTAAGAA
AAGCTGTATGGCTAATTCA -> AGCTGTATGGCTAATTCAG
CTTTCCCAAGCTAGATCAA -> TTTCCCAAGCTAGATCAAC
CGAGACCGCGCATCTTACT -> GAGACCGCGCATCTTACTT
GAGGAAAGACCGGACTGGC -> AGGAAAGACCGGACTGGCA
TCAGCAAGGATGCGTTGGG -> CAGCAAGGATGCGTTGGGC
GGTGGGAGAAAAGGGAACA -> GTGGGAGAAAAGGGAACAC
ATGCCCTCGCGCACACCCC -> TGCCCTCGCGCACACCCCT
TTGGTGGGAGAAAAGGGAA -> TGGTGGGAGAAAAGGGAAC
ATGATCCGAGCCACCCTCC -> TGATCCGAGCCACCCTCCA
GCTAGATCAACTGTTTAGC -> CTAGATCAACTGTTTAGCC
TGGGAAAATCGACTAAATC -> GGGAAAATCGACTAAATCA
CCGCATGTTGTAGTTCCCC -> CGCATGTTGTAGTTCCCCC
AGGCACATGCATACTGGAC -> GGCACATGCATACTGGACG
AGTGAGGGGTCAGAACTAG -> GTGAGGGGTCAGAACTAGG
TTAGCCGACCTTACGGATT -> TAGCCGACCTTACGGATTG
CGGCCCAAACCGTTGAGAA -> GGCCCAAACCGTTGAGAAC
ACGACCCGGCTTCATGTTC -> CGACCCGGCTTCATGTTCC
CCCTTCACCCACATTATAG -> CCTTCACCCACATTATAGT
ACAACCTTGATCAGTGAGG -> CAACCTTGATCAGTGAGGG
GGCCAAGCAGTTGCTGAAA -> GCCAAGCAGTTGCTGAAAT
CATGGTCTTATGTAATGCC -> ATGGTCTTATGTAATGCCA
TCTTTAGCCGACCTTACGG -> CTTTAGCCGACCTTACGGA
CGCGCATCTTACTTTCAAC -> GCGCATCTTACTTTCAACG
GGTACGGATACTCTGGAAT -> GTACGGATACTCTGGAATA
TCCTTCTGGTTATTTAGGT -> CCTTCTGGTTATTTAGGTA
TATTTTCGCGTTGTCACTT -> ATTTTCGCGTTGTCACTTG
TTCTAGTATCATGGGTGTG -> TCTAGTATCATGGGTGTGC
CCAGGGAAGCTGTATGGCT -> CAGGGAAGCTGTATGGCTA
AGAAACGGTGTTTTCAACT -> GAAACGGTGTTTTCAACTG
ATTCAGCAAGGATGCGTTG -> TTCAGCAAGGATGCGTTGG
GGGCTTTTAACTGAAAGAA -> GGCTTTTAACTGAAAGAAG
GAGCGGAAAAGAATGAGAA -> AGCGGAAAAGAATGAGAAA
GCGATGAACAGCACTCGCA -> CGATGAACAGCACTCGCAA
CAAATTAGCGATATATATC -> AAATTAGCGATATATATCG
TTCAACGGCCACTGCACTA -> TCAACGGCCACTGCACTAG
CCCGAAAACACCAATACCG -> CCGAAAACACCAATACCGA
TACCGATACAACCTTGATC -> ACCGATACAACCTTGATCA
CGTAATTTCCATCAGGCGA -> GTAATTTCCATCAGGCGAG
ACTACTGTCAGGGAACATC -> CTACTGTCAGGGAACATCA
TCCAGCGGTTAGAAAACCG -> CCAGCGGTTAGAAAACCGT
CTCAGTAATACCGCACACA -> TCAGTAATACCGCACACAC
CATTAGACCCCGACGGTAA -> ATTAGACCCCGACGGTAAT
TCTCCTTCTGGTTATTTAG -> CTCCTTCTGGTTATTTAGG
GCTGAAATCTTTAGCCGAC -> CTGAAATCTTTAGCCGACC
GGTCGCTACAGTTACCCGC -> GTCGCTACAGTTACCCGCA
CCTTAGACCTCCAGCGGTT -> CTTAGACCTCCAGCGGTTA
CTGGAAAGGGCCCAAGCAT -> TGGAAAGGGCCCAAGCATT
ATTCAGAGCTAGTTTTAAG -> TTCAGAGCTAGTTTTAAGT
GAGCTAAGTCCGAGAACCT -> AGCTAAGTCCGAGAACCTG
GAGGTCTGGGAGGGGAGAA -> AGGTCTGGGAGGGGAGAAC
CGAGAACCTGAGTTCCATC -> GAGAACCTGAGTTCCATCT
GGCTAATTCAGAGCTAGTT -> GCTAATTCAGAGCTAGTTT
TAATTTCCATCAGGCGAGC -> AATTTCCATCAGGCGAGCG
TAGGTATCTAAGGAGTAGT -> AGGTATCTAAGGAGTAGTG
GATGCGTTGGGCAAGGGGA -> ATGCGTTGGGCAAGGGGAT
CGACGGTAATGGTCCGTGG -> GACGGTAATGGTCCGTGGC
AGCTGTATGGCTAATTCAG -> GCTGTATGGCTAATTCAGA
GACCAGGCTCTGGTACGGA -> ACCAGGCTCTGGTACGGAT
AAGCTCCAGACCTGGAAAG -> AGCTCCAGACCTGGAAAGG
AAGCGAGTGCCGCAATATG -> AGCGAGTGCCGCAATATGT
TCAAAATGGTGGGACCCAC -> CAAAATGGTGGGACCCACT
AAAGGGAACACTCCGCCCC -> AAGGGAACACTCCGCCCCT
AAGGTCCATGCAGGGCAGC -> AGGTCCATGCAGGGCAGCT
GCTAATTCAGAGCTAGTTT -> CTAATTCAGAGCTAGTTTT
TTGCTACTGGGGGATTGCC -> TGCTACTGGGGGATTGCCA
GTTGAGAACACGAGGAAAG -> TTGAGAACACGAGGAAAGA
CAACTACAGCAATGAGGAC -> AACTACAGCAATGAGGACC
ACTGACAGGCATGACCAGG -> CTGACAGGCATGACCAGGC
TACTAGTGAAAAGAAGCTC -> ACTAGTGAAAAGAAGCTCC
ACGGATTGTGAGACCACCT -> CGGATTGTGAGACCACCTC
CTAGTTGGGAAAATCGACT -> TAGTTGGGAAAATCGACTA
CTGGCCGATACCTTGGTGG -> TGGCCGATACCTTGGTGGG
AAGTGAAATGCGCCTATCG -> AGTGAAATGCGCCTATCGG
CCAGGCTCTGGTACGGATA -> CAGGCTCTGGTACGGATAC
AGCGAGTGCCGCAATATGT -> GCGAGTGCCGCAATATGTG
CTCGCGGCCCAAACCGTTG -> TCGCGGCCCAAACCGTTGA
GCCGCATGTTGTAGTTCCC -> CCGCATGTTGTAGTTCCCC
AACCGTTGAGAACACGAGG -> ACCGTTGAGAACACGAGGA
ACAAGGGATGTAAAACTGG -> CAAGGGATGTAAAACTGGC
AGCTTGTCCGTGTAGTTCC -> GCTTGTCCGTGTAGTTCCT
ATGCCACGTAATTTCCATC -> TGCCACGTAATTTCCATCA
CCACATTATAGTAAGCAAC -> CACATTATAGTAAGCAACG
TGTGGACCCGACCACGACG -> GTGGACCCGACCACGACGG
TGACCTTTCGCCGTGCTTC -> GACCTTTCGCCGTGCTTCA
AACATCTTAGCTTCCTCAC -> ACATCTTAGCTTCCTCACC
TCTAGTATCATGGGTGTGC -> CTAGTATCATGGGTGTGCG
CTCCGTCAACCGACGCCGC -> TCCGTCAACCGACGCCGCA
GAGAACACGAGGAAAGACC -> AGAACACGAGGAAAGACCG
CTGGCACTAAATGACCTTT -> TGGCACTAAATGACCTTTC
CGTTCTAATGCATAAGTCA -> GTTCTAATGCATAAGTCAC
ACCGTTGGGTGACTGGACG -> CCGTTGGGTGACTGGACGG
CGGACTCCAAATGTCCCCG -> GGACTCCAAATGTCCCCGT
CGCGGCCCAAACCGTTGAG -> GCGGCCCAAACCGTTGAGA
CCGCCATGAGACTGGTTAT -> CGCCATGAGACTGGTTATG
ATGTAAAACTGGCCGATAC -> TGTAAAACTGGCCGATACC
CATACATAGCACGAGTGTG -> ATACATAGCACGAGTGTGC
ACAGGCATGACCAGGCTCT -> CAGGCATGACCAGGCTCTG
TACCCGCAACTACGACCCG -> ACCCGCAACTACGACCCGG
AATGCCACACGGGCTTTTA -> ATGCCACACGGGCTTTTAA
CATGGGTGTGCGCCGCATG -> ATGGGTGTGCGCCGCATGT
ATTTCCATCAGGCGAGCGA -> TTTCCATCAGGCGAGCGAT
GAAAAGAATGAGAAAAAAA -> AAAAGAATGAGAAAAAAAC
TCCGTGGCTGATCACGAGT -> CCGTGGCTGATCACGAGTA
CGACCACGACGGAGGACTC -> GACCACGACGGAGGACTCA
GGTATCTAAGGAGTAGTGG -> GTATCTAAGGAGTAGTGGA
TCAGAACTAGGTTTCGACC -> CAGAACTAGGTTTCGACCG
AGAACTGACAGGCATGACC -> GAACTGACAGGCATGACCA
CTACTGGTTCATGCGATAT -> TACTGGTTCATGCGATATT
TTTAGCCGCCTACTACTCC -> TTAGCCGCCTACTACTCCA
GGACTGGCACTAAATGACC -> GACTGGCACTAAATGACCT
TCAACTGGACGGCTCCCGA -> CAACTGGACGGCTCCCGAA
TCCCGAAAACACCAATACC -> CCCGAAAACACCAATACCG
TAGAAATTTTAAGTCGGAC -> AGAAATTTTAAGTCGGACT
CTCGCCGTGCTTTCCCAAG -> TCGCCGTGCTTTCCCAAGC
GAGCTACCAGTGGATCACT -> AGCTACCAGTGGATCACTA
CATCTGAACATCGGGCGTA -> ATCTGAACATCGGGCGTAC
GGCATGACCAGGCTCTGGT -> GCATGACCAGGCTCTGGTA
TATTGGTTCAATGTCCCTT -> ATTGGTTCAATGTCCCTTC
GCGTCCTGTGTTATCGTCA -> CGTCCTGTGTTATCGTCAA
GACGGCTCCCGAAAACTAC -> ACGGCTCCCGAAAACTACT
ACCGGGGGGCATCTAGTTG -> CCGGGGGGCATCTAGTTGG
AAGCATTAGACCCCGACGG -> AGCATTAGACCCCGACGGT
GTGAAATGCGCCTATCGGA -> TGAAATGCGCCTATCGGAC
CTTCATAGTCTGGAAGGCA -> TTCATAGTCTGGAAGGCAA
AGCTTCATTATTGGTTCAA -> GCTTCATTATTGGTTCAAT
ATACCTGTTGTGTACTAGT -> TACCTGTTGTGTACTAGTG
TGTACTAGTGAAAAGAAGC -> GTACTAGTGAAAAGAAGCT
TGGTTCAATGTCCCTTCAC -> GGTTCAATGTCCCTTCACC
GAGAAAAAAACTGCGTAAT -> AGAAAAAAACTGCGTAATC
TAAGCATTCCATCTGAACA -> AAGCATTCCATCTGAACAT
CCAGCGGTTAGAAACGGTG -> CAGCGGTTAGAAACGGTGT
CTCCAGACCTGGAAAGGGC -> TCCAGACCTGGAAAGGGCC
TATGGGGCCAAGCAGTTGC -> ATGGGGCCAAGCAGTTGCT
CCACTGCACTAGCCAGTGA -> CACTGCACTAGCCAGTGAG
TCCAAATGTCCCCGTGGCA -> CCAAATGTCCCCGTGGCAC
GCTTCCTTTTAACCTCCAG -> CTTCCTTTTAACCTCCAGC
GATCCGCTTTAGTAGCGTA -> ATCCGCTTTAGTAGCGTAG
CCAGCGGTTAGAAATTTTA -> CAGCGGTTAGAAATTTTAA
TCCCGTTCTAGTATCATGG -> CCCGTTCTAGTATCATGGG
TAGGCCAGAGCTAAGTCCG -> AGGCCAGAGCTAAGTCCGA
CTTGGTACGAGTAACTTTC -> TTGGTACGAGTAACTTTCC
ACCTAAGAAGTATGCCTTA -> CCTAAGAAGTATGCCTTAG
AGCGGTTAGAAAGGCACAT -> GCGGTTAGAAAGGCACATG
TACTGGACGGCTCCCGAAA -> ACTGGACGGCTCCCGAAAA
GGACTCAGTAATACCGCAC -> GACTCAGTAATACCGCACA
CGGCGATATAAGCGCGCGT -> GGCGATATAAGCGCGCGTA
TTAACTGAAAGAAGTTCTT -> TAACTGAAAGAAGTTCTTA
ATTGGTTCAATGTCCCTTC -> TTGGTTCAATGTCCCTTCA
GATATAAGCGCGCGTAGTG -> ATATAAGCGCGCGTAGTGA
GGAAGGCAACTAGCCTAGG -> GAAGGCAACTAGCCTAGGT
TGACACGCAAGCATTAGGC -> GACACGCAAGCATTAGGCC
AAAATTTTGAGGTCTGGGA -> AAATTTTGAGGTCTGGGAG
CCTTACGGATTGTGAGACC -> CTTACGGATTGTGAGACCA
CAGCGGTTAGAAAGGCACA -> AGCGGTTAGAAAGGCACAT
GAAGCTGTATGGCTAATTC -> AAGCTGTATGGCTAATTCA
CATAGTCTGGAAGGCAACT -> ATAGTCTGGAAGGCAACTA
CTGTTTAGCCGCCTACTAC -> TGTTTAGCCGCCTACTACT
ATGCATACTGGACGGCTCC -> TGCATACTGGACGGCTCCC
CAACTACGACCCGGCTTCA -> AACTACGACCCGGCTTCAT
ACGAGACCGCGCATCTTAC -> CGAGACCGCGCATCTTACT
GTGCTTTCCCAAGCTAGAT -> TGCTTTCCCAAGCTAGATC
GAAGAACCGCTCCTACTCA -> AAGAACCGCTCCTACTCAA
GCGCACACCCCTGTTCAAC -> CGCACACCCCTGTTCAACT
TCGCGTTGTCACTTGGTAC -> CGCGTTGTCACTTGGTACG
ATCTGTCACGATTTAGAGG -> TCTGTCACGATTTAGAGGT
ACTCGCAATGAAGGGATCC -> CTCGCAATGAAGGGATCCG
TCCCTTCACCCACATTATA -> CCCTTCACCCACATTATAG
ACACCCCTGTTCAACTATA -> CACCCCTGTTCAACTATAG
CACCCACATTATAGTAAGC -> ACCCACATTATAGTAAGCA
TCGCAGGAGCTCTGAAGCC -> CGCAGGAGCTCTGAAGCCC
CCCGCAACTACGACCCGGC -> CCGCAACTACGACCCGGCT
TTCACCCACATTATAGTAA -> TCACCCACATTATAGTAAG
AAGGATGCGTTGGGCAAGG -> AGGATGCGTTGGGCAAGGG
CAGCGGTTAGAAATTTTAA -> AGCGGTTAGAAATTTTAAG
CACGAGGAAAGACCGGACT -> ACGAGGAAAGACCGGACTG
GTTGATGTGCAAATTAGCG -> TTGATGTGCAAATTAGCGA
CATCAGGCGAGCGATGAAC -> ATCAGGCGAGCGATGAACA
CATTATAGTAAGCAACGAG -> ATTATAGTAAGCAACGAGA
TCAGTAGAGCGGAAAAGAA -> CAGTAGAGCGGAAAAGAAT
TGGTCCGTGGCTGATCACG -> GGTCCGTGGCTGATCACGA
CTGGGGGATTGCCATGGTC -> TGGGGGATTGCCATGGTCT
GGTGGGACCCACTTGCATC -> GTGGGACCCACTTGCATCC
GGTTCAGTAGAGCGGAAAA -> GTTCAGTAGAGCGGAAAAG
AACCGACGCCGCACGCTAT -> ACCGACGCCGCACGCTATG
ACCTCCAGCGGTTAGAAAG -> CCTCCAGCGGTTAGAAAGG
GGGGATTGCCATGGTCTTA -> GGGATTGCCATGGTCTTAT
TGGCTGATCACGAGTATAT -> GGCTGATCACGAGTATATT
GACTGGACGGCTCCCGAAA -> ACTGGACGGCTCCCGAAAA,ACTGGACGGCTCCCGAAAA
GGGAACATCACAGCGTCAT -> GGAACATCACAGCGTCATA
CAGGACCTCTTTGCTAATA -> AGGACCTCTTTGCTAATAC
AATGATCCGAGCCACCCTC -> ATGATCCGAGCCACCCTCC
GTTACCCGCAACTACGACC -> TTACCCGCAACTACGACCC
CACATTATAGTAAGCAACG -> ACATTATAGTAAGCAACGA
TGTGTTATCGTCAACTACA -> GTGTTATCGTCAACTACAG
CCTTCACCCACATTATAGT -> CTTCACCCACATTATAGTA
AATGCCCTCGCGCACACCC -> ATGCCCTCGCGCACACCCC
CACGTATAAACTTTTATGC -> ACGTATAAACTTTTATGCT
ATCTATTAAGCATTCCATC -> TCTATTAAGCATTCCATCT
ACACTCCGCCCCTCTTTTC -> CACTCCGCCCCTCTTTTCC
CCCCTGTTCAACTATAGCG -> CCCTGTTCAACTATAGCGA
TCTGGAAGGCAACTAGCCT -> CTGGAAGGCAACTAGCCTA
ATACATAGCACGAGTGTGC -> TACATAGCACGAGTGTGCA
TGTTGTAGTTCCCCCATCT -> GTTGTAGTTCCCCCATCTA
TGGGGCGGGGTCCTATCTC -> GGGGCGGGGTCCTATCTCA
TCCCGAAAAATTTTGAGGT -> CCCGAAAAATTTTGAGGTC
CTGTTACAACCCACCTAAG -> TGTTACAACCCACCTAAGA
GCCATGAGACTGGTTATGG -> CCATGAGACTGGTTATGGG
AGTAAGCAACGAGACCGCG -> GTAAGCAACGAGACCGCGC
TATTCAGCAAGGATGCGTT -> ATTCAGCAAGGATGCGTTG
TAAGTGAAATGCGCCTATC -> AAGTGAAATGCGCCTATCG
TTGGTTCAATGTCCCTTCA -> TGGTTCAATGTCCCTTCAC
TACTGGGGGATTGCCATGG -> ACTGGGGGATTGCCATGGT
CGGCTCCCGAAAACTACTG -> GGCTCCCGAAAACTACTGT
GTTCTAGTATCATGGGTGT -> TTCTAGTATCATGGGTGTG
GCTTTCCCAAGCTAGATCA -> CTTTCCCAAGCTAGATCAA
GTCCTATCTCAGAACTGAC -> TCCTATCTCAGAACTGACA
GCAGGGCAGCTTCCTTTTA -> CAGGGCAGCTTCCTTTTAA
TGATCACGAGTATATTCAG -> GATCACGAGTATATTCAGC
ACATCTTAGCTTCCTCACC -> CATCTTAGCTTCCTCACCT
GTTAGAAACGGTGTTTTCA -> TTAGAAACGGTGTTTTCAA
CGAGGAAAGACCGGACTGG -> GAGGAAAGACCGGACTGGC
GTTATGGGGCCAAGCAGTT -> TTATGGGGCCAAGCAGTTG
AGTGGAGCTTGTCCGTGTA -> GTGGAGCTTGTCCGTGTAG
GGTCCATGCAGGGCAGCTT -> GTCCATGCAGGGCAGCTTC
CGTGCTTCATAGTCTGGAA -> GTGCTTCATAGTCTGGAAG
AGCGCGCGTAGTGACACGC -> GCGCGCGTAGTGACACGCA
TCACCCACATTATAGTAAG -> CACCCACATTATAGTAAGC
AGCGGAAAAGAATGAGAAA -> GCGGAAAAGAATGAGAAAA
GTCCGAGAACCTGAGTTCC -> TCCGAGAACCTGAGTTCCA
CGCATCTTACTTTCAACGG -> GCATCTTACTTTCAACGGC
ATGCTAAATGCCCTCGCGC -> TGCTAAATGCCCTCGCGCA
GTTCCATCTGTCACGATTT -> TTCCATCTGTCACGATTTA
AGGAGCTCTGAAGCCCGCC -> GGAGCTCTGAAGCCCGCCA
AACCGCTCCTACTCAACTA -> ACCGCTCCTACTCAACTAA
TCCGAGAACCTGAGTTCCA -> CCGAGAACCTGAGTTCCAT
GTCAGAACTAGGTTTCGAC -> TCAGAACTAGGTTTCGACC
TTCCTTGCCCCAACATCTT -> TCCTTGCCCCAACATCTTA
TGGAGCTTGTCCGTGTAGT -> GGAGCTTGTCCGTGTAGTT
ATGTTGTAGTTCCCCCATC -> TGTTGTAGTTCCCCCATCT
TGATCAGTGAGGGGTCAGA -> GATCAGTGAGGGGTCAGAA
AAGGGCCCAAGCATTAGAC -> AGGGCCCAAGCATTAGACC
TATCGTCAACTACAGCAAT -> ATCGTCAACTACAGCAATG
TTTTCAACTGGACGGCTCC -> TTTCAACTGGACGGCTCCC
AGCTCCAGACCTGGAAAGG -> GCTCCAGACCTGGAAAGGG
TATGCCTTAGACCTCCAGC -> ATGCCTTAGACCTCCAGCG
TACTCAACTAAAATTCTCG -> ACTCAACTAAAATTCTCGC
CATGCGATATTTTCGCGTT -> ATGCGATATTTTCGCGTTG
GTCGGACTGGACGGCTCCC -> TCGGACTGGACGGCTCCCG
CTGTATGGCTAATTCAGAG -> TGTATGGCTAATTCAGAGC
AGAACCTGAGTTCCATCTG -> GAACCTGAGTTCCATCTGT
AGGCGAGCGATGAACAGCA -> GGCGAGCGATGAACAGCAC
ACCAAGAACCGTGCGACCC -> CCAAGAACCGTGCGACCCT
AAGAAGCTCCAGACCTGGA -> AGAAGCTCCAGACCTGGAA
CGCATGTTGTAGTTCCCCC -> GCATGTTGTAGTTCCCCCA
TCGCAATGAAGGGATCCGC -> CGCAATGAAGGGATCCGCT
TGCGCCTATCGGACTCCAA -> GCGCCTATCGGACTCCAAA
GGTCTTATGTAATGCCACA -> GTCTTATGTAATGCCACAC
ACCTGGAAAGGGCCCAAGC -> CCTGGAAAGGGCCCAAGCA
GGCTTTTAACTGAAAGAAG -> GCTTTTAACTGAAAGAAGT
CGGTTAGAAACGGTGTTTT -> GGTTAGAAACGGTGTTTTC
AACCCACCTAAGAAGTATG -> ACCCACCTAAGAAGTATGC
TCCATCTGAACATCGGGCG -> CCATCTGAACATCGGGCGT
TATTCGTCAGCTTCATTAT -> ATTCGTCAGCTTCATTATT
TCCAGCGGTTAGAAACGGT -> CCAGCGGTTAGAAACGGTG
TCAACTGTTTAGCCGCCTA -> CAACTGTTTAGCCGCCTAC
ACTCTCCTTCTGGTTATTT -> CTCTCCTTCTGGTTATTTA
ACTGGGGGATTGCCATGGT -> CTGGGGGATTGCCATGGTC
ATATGCTAAGCTAATGATC -> TATGCTAAGCTAATGATCC
CGACGTCAAAATGGTGGGA -> GACGTCAAAATGGTGGGAC
CTGGGAGGGGAGAACCTAC -> TGGGAGGGGAGAACCTACT
CCTCTTTGCTAATACCTGT -> CTCTTTGCTAATACCTGTT
TCCAGGGAAGCTGTATGGC -> CCAGGGAAGCTGTATGGCT
AGTGCCGCAATATGTGTAG -> GTGCCGCAATATGTGTAGG
ACGGTAATGGTCCGTGGCT -> CGGTAATGGTCCGTGGCTG
CTTTTCCCCAGGACCTCTT -> TTTTCCCCAGGACCTCTTT
GTTCTAATGCATAAGTCAC -> TTCTAATGCATAAGTCACT
ACTGCGTAATCCCGTGTCC -> CTGCGTAATCCCGTGTCCT
TGTTGTTGACTCGTTCAGA -> GTTGTTGACTCGTTCAGAC
CCAAGCTAGATCAACTGTT -> CAAGCTAGATCAACTGTTT
CTGGACGGCTCCCGAAAAC -> TGGACGGCTCCCGAAAACA,TGGACGGCTCCCGAAAACT
AGCATTCCATCTGAACATC -> GCATTCCATCTGAACATCG
AACTTTCCTTGCCCCAACA -> ACTTTCCTTGCCCCAACAT
CGCCGTGCTTTCCCAAGCT -> GCCGTGCTTTCCCAAGCTA
CGTAATCCCGTGTCCTGTT -> GTAATCCCGTGTCCTGTTA
CAGACCTGGAAAGGGCCCA -> AGACCTGGAAAGGGCCCAA
CTTACGGATTGTGAGACCA -> TTACGGATTGTGAGACCAC
AAGGGATCCGCTTTAGTAG -> AGGGATCCGCTTTAGTAGC
TATGTTCGCAGGAGCTCTG -> ATGTTCGCAGGAGCTCTGA
GCATTCCATCTGAACATCG -> CATTCCATCTGAACATCGG
TTCCTTGCTACTGGGGGAT -> TCCTTGCTACTGGGGGATT
GTGGAGCTTGTCCGTGTAG -> TGGAGCTTGTCCGTGTAGT
GCGTTAGGTTCAGTAGAGC -> CGTTAGGTTCAGTAGAGCG
CTCCGCCCCTCTTTTCCCC -> TCCGCCCCTCTTTTCCCCA
CCACGTAATTTCCATCAGG -> CACGTAATTTCCATCAGGC
TCATAGTCTGGAAGGCAAC -> CATAGTCTGGAAGGCAACT
AAGGGGATGCCACGTAATT -> AGGGGATGCCACGTAATTT
GTGGGAGAAAAGGGAACAC -> TGGGAGAAAAGGGAACACT
TACAGTTACCCGCAACTAC -> ACAGTTACCCGCAACTACG
GAAGGCAACTAGCCTAGGT -> AAGGCAACTAGCCTAGGTA
CTGGAAGGCAACTAGCCTA -> TGGAAGGCAACTAGCCTAG
AGAGCTAGTTTTAAGTGAA -> GAGCTAGTTTTAAGTGAAA
CTCACCTAATGAGCAACAT -> TCACCTAATGAGCAACATC
TTTAGGTATCTAAGGAGTA -> TTAGGTATCTAAGGAGTAG
TGATCCCGTTCTAGTATCA -> GATCCCGTTCTAGTATCAT
AACGGCCACTGCACTAGCC -> ACGGCCACTGCACTAGCCA
AAGCAACGAGACCGCGCAT -> AGCAACGAGACCGCGCATC
TGAACATCGGGCGTACTCT -> GAACATCGGGCGTACTCTC
TGTAGTTCCTTGCTACTGG -> GTAGTTCCTTGCTACTGGG
ACTGGCACTAAATGACCTT -> CTGGCACTAAATGACCTTT
GAGTTCCATCTGTCACGAT -> AGTTCCATCTGTCACGATT
GCGCATCTTACTTTCAACG -> CGCATCTTACTTTCAACGG
ATTAGACCCCGACGGTAAT -> TTAGACCCCGACGGTAATG
GGGGGGCATCTAGTTGGGA -> GGGGGCATCTAGTTGGGAA
TACTGTCAGGGAACATCAC -> ACTGTCAGGGAACATCACA
CCGCACGCTATGTTCGCAG -> CGCACGCTATGTTCGCAGG
GTAGTGGAGCTTGTCCGTG -> TAGTGGAGCTTGTCCGTGT
AAATCTTTAGCCGACCTTA -> AATCTTTAGCCGACCTTAC
CCAAGCAGTTGCTGAAATC -> CAAGCAGTTGCTGAAATCT
ATCCAGCGGCGATATAAGC -> TCCAGCGGCGATATAAGCG
CGGGGTCCTATCTCAGAAC -> GGGGTCCTATCTCAGAACT
GGGAACACTCCGCCCCTCT -> GGAACACTCCGCCCCTCTT
CACGCTATGTTCGCAGGAG -> ACGCTATGTTCGCAGGAGC
TCAGAACTGACAGGCATGA -> CAGAACTGACAGGCATGAC
TGGACCCGACCACGACGGA -> GGACCCGACCACGACGGAG
AGGCAACTAGCCTAGGTAT -> GGCAACTAGCCTAGGTATT
AGGACTCAGTAATACCGCA -> GGACTCAGTAATACCGCAC
ATATTCAGCAAGGATGCGT -> TATTCAGCAAGGATGCGTT
AGCTAAGTCCGAGAACCTG -> GCTAAGTCCGAGAACCTGA
GACGGCTCCCGAAAATACA -> ACGGCTCCCGAAAATACAC
CACCCATACATAGCACGAG -> ACCCATACATAGCACGAGT
CACACCCCTGTTCAACTAT -> ACACCCCTGTTCAACTATA
AGCGATAGTGGTCGCTACA -> GCGATAGTGGTCGCTACAG
TCCCCAGTTCGGATACAAG -> CCCCAGTTCGGATACAAGG
TACAACCCACCTAAGAAGT -> ACAACCCACCTAAGAAGTA
ATAAGCGCGCGTAGTGACA -> TAAGCGCGCGTAGTGACAC
CAAATGTCCCCGTGGCACG -> AAATGTCCCCGTGGCACGA
ATGCGATATTTTCGCGTTG -> TGCGATATTTTCGCGTTGT
GGGTGTGCGCCGCATGTTG -> GGTGTGCGCCGCATGTTGT
ATTTTCGCGTTGTCACTTG -> TTTTCGCGTTGTCACTTGG
AGAAAAAAACTGCGTAATC -> GAAAAAAACTGCGTAATCC
TAAGCGAGTGCCGCAATAT -> AAGCGAGTGCCGCAATATG
ATGGTGGGACCCACTTGCA -> TGGTGGGACCCACTTGCAT
ACTTGTGATCCCGTTCTAG -> CTTGTGATCCCGTTCTAGT
AGTTCGGATACAAGGGATG -> GTTCGGATACAAGGGATGT
TTGTGTACTAGTGAAAAGA -> TGTGTACTAGTGAAAAGAA
AGAACACGAGGAAAGACCG -> GAACACGAGGAAAGACCGG
GCTACCTCCAGCGGTTAGA -> CTACCTCCAGCGGTTAGAA
CTTTCAACGGCCACTGCAC -> TTTCAACGGCCACTGCACT
AATCCCGTGTCCTGTTACA -> ATCCCGTGTCCTGTTACAA
AACACGAGGAAAGACCGGA -> ACACGAGGAAAGACCGGAC
GGTCCGTGGCTGATCACGA -> GTCCGTGGCTGATCACGAG
GCCAAGCAGTTGCTGAAAT -> CCAAGCAGTTGCTGAAATC
CAACCCACCTAAGAAGTAT -> AACCCACCTAAGAAGTATG
CCACCCTCCAGCTACCTCC -> CACCCTCCAGCTACCTCCA
TTAACCTCCAGCGGTTAGA -> TAACCTCCAGCGGTTAGAA
GGATACAAGGGATGTAAAA -> GATACAAGGGATGTAAAAC
CCTCCAGCGGTTAGAAACG -> CTCCAGCGGTTAGAAACGG
ACGACGTCAAAATGGTGGG -> CGACGTCAAAATGGTGGGA
ATCTTACTTTCAACGGCCA -> TCTTACTTTCAACGGCCAC
ATCGGGCGTACTCTCCTTC -> TCGGGCGTACTCTCCTTCT
TTCCATCTGAACATCGGGC -> TCCATCTGAACATCGGGCG
TGAGGCTAGGAAGAACCGC -> GAGGCTAGGAAGAACCGCT
AACATATGCTAAGCTAATG -> ACATATGCTAAGCTAATGA
GTCAAAATGGTGGGACCCA -> TCAAAATGGTGGGACCCAC
AAACTGCGTAATCCCGTGT -> AACTGCGTAATCCCGTGTC
AAAACTGGCCGATACCTTG -> AAACTGGCCGATACCTTGG
CACGAGTGTGCATGTTGTT -> ACGAGTGTGCATGTTGTTG
AGACCTGGAAAGGGCCCAA -> GACCTGGAAAGGGCCCAAG
ACGAGTATATTCAGCAAGG -> CGAGTATATTCAGCAAGGA
AAAATACACACCCATACAT -> AAATACACACCCATACATA
TAACTTTCCTTGCCCCAAC -> AACTTTCCTTGCCCCAACA
TGTCACTTGGTACGAGTAA -> GTCACTTGGTACGAGTAAC
TAGTGAAAAGAAGCTCCAG -> AGTGAAAAGAAGCTCCAGA
CTTAGACCTCCAGCGGTTA -> TTAGACCTCCAGCGGTTAG
GGCATCTAGTTGGGAAAAT -> GCATCTAGTTGGGAAAATC
CTATCTCAGAACTGACAGG -> TATCTCAGAACTGACAGGC
GTCTGGAAGGCAACTAGCC -> TCTGGAAGGCAACTAGCCT
CCTTTTAACCTCCAGCGGT -> CTTTTAACCTCCAGCGGTT
CTTTTAACCTCCAGCGGTT -> TTTTAACCTCCAGCGGTTA
ATGAAGGGATCCGCTTTAG -> TGAAGGGATCCGCTTTAGT
CCTATCGGACTCCAAATGT -> CTATCGGACTCCAAATGTC
CACTAGCCAGTGAGCTACC -> ACTAGCCAGTGAGCTACCA
AAAACCGTTGGGTGACTGG -> AAACCGTTGGGTGACTGGA
TGAACAGCACTCGCAATGA -> GAACAGCACTCGCAATGAA
TTCATTATTGGTTCAATGT -> TCATTATTGGTTCAATGTC
TGCCCTCGCGCACACCCCT -> GCCCTCGCGCACACCCCTG
CATGACCAGGCTCTGGTAC -> ATGACCAGGCTCTGGTACG
ATACAAGGGATGTAAAACT -> TACAAGGGATGTAAAACTG
TATAGCGATAGTGGTCGCT -> ATAGCGATAGTGGTCGCTA
TCCGCAACATATGCTAAGC -> CCGCAACATATGCTAAGCT
GTCGCTACAGTTACCCGCA -> TCGCTACAGTTACCCGCAA
TGTCCCCGTGGCACGACGA -> GTCCCCGTGGCACGACGAC
AGGGCAGCTTCCTTTTAAC -> GGGCAGCTTCCTTTTAACC
AGAAGTTCTTAGCTCGTGT -> GAAGTTCTTAGCTCGTGTG
ATGCATAAGTCACTTGTGA -> TGCATAAGTCACTTGTGAT
CCATGCAGGGCAGCTTCCT -> CATGCAGGGCAGCTTCCTT
TCGGCATGAGGCTAGGAAG -> CGGCATGAGGCTAGGAAGA
GAAAGGGCCCAAGCATTAG -> AAAGGGCCCAAGCATTAGA
CAGCTTCCTTTTAACCTCC -> AGCTTCCTTTTAACCTCCA
AAAACACCAATACCGATAC -> AAACACCAATACCGATACA
TTTTAAGTGAAATGCGCCT -> TTTAAGTGAAATGCGCCTA
TCTAAGGAGTAGTGGAGCT -> CTAAGGAGTAGTGGAGCTT
CCGTTGGGTGACTGGACGG -> CGTTGGGTGACTGGACGGC
CAAGCATTAGACCCCGACG -> AAGCATTAGACCCCGACGG
TCGCGGCCCAAACCGTTGA -> CGCGGCCCAAACCGTTGAG
TCAGTAATACCGCACACAC -> CAGTAATACCGCACACACG
TTAGAAATTTTAAGTCGGA -> TAGAAATTTTAAGTCGGAC
ACTAAATGACCTTTCGCCG -> CTAAATGACCTTTCGCCGT
CATGTTGTTGACTCGTTCA -> ATGTTGTTGACTCGTTCAG
CCCGACGGTAATGGTCCGT -> CCGACGGTAATGGTCCGTG
CCATACATAGCACGAGTGT -> CATACATAGCACGAGTGTG
GCCGCACGCTATGTTCGCA -> CCGCACGCTATGTTCGCAG
CTAGGAAGAACCGCTCCTA -> TAGGAAGAACCGCTCCTAC
TTTAGTGAACACGTATAAA -> TTAGTGAACACGTATAAAC
TCTCGCCGTGCTTTCCCAA -> CTCGCCGTGCTTTCCCAAG
TTATGCTAAATGCCCTCGC -> TATGCTAAATGCCCTCGCG
GCTAAGTCCGAGAACCTGA -> CTAAGTCCGAGAACCTGAG
CATCCCCAGTTCGGATACA -> ATCCCCAGTTCGGATACAA
GAAAAATTTTGAGGTCTGG -> AAAAATTTTGAGGTCTGGG
ACTCAGTAATACCGCACAC -> CTCAGTAATACCGCACACA
AACTACTGTCAGGGAACAT -> ACTACTGTCAGGGAACATC
ATGTGTAGGTCTTGGATCA -> TGTGTAGGTCTTGGATCAC
TTCCCCAGGACCTCTTTGC -> TCCCCAGGACCTCTTTGCT
CATGCAGGGCAGCTTCCTT -> ATGCAGGGCAGCTTCCTTT
TGGTTATGGGGCCAAGCAG -> GGTTATGGGGCCAAGCAGT
GAAGGGATCCGCTTTAGTA -> AAGGGATCCGCTTTAGTAG
CCCCTCTTTTCCCCAGGAC -> CCCTCTTTTCCCCAGGACC
TTCCCAAGCTAGATCAACT -> TCCCAAGCTAGATCAACTG
CCTCGCGCACACCCCTGTT -> CTCGCGCACACCCCTGTTC
CGCGTTAGGTTCAGTAGAG -> GCGTTAGGTTCAGTAGAGC
GTTCATGCGATATTTTCGC -> TTCATGCGATATTTTCGCG
ACAGCGTCATATCGGCATG -> CAGCGTCATATCGGCATGA
TCAGCTTCATTATTGGTTC -> CAGCTTCATTATTGGTTCA
CACTAAATGACCTTTCGCC -> ACTAAATGACCTTTCGCCG
CCGAAAACACCAATACCGA -> CGAAAACACCAATACCGAT
CCAGCTACCTCCAGCGGTT -> CAGCTACCTCCAGCGGTTA
TGCACTATACTCGCGGCCC -> GCACTATACTCGCGGCCCA
GTATCTAAGGAGTAGTGGA -> TATCTAAGGAGTAGTGGAG
GATACTCTGGAATAAGCGA -> ATACTCTGGAATAAGCGAG
ACCCACATTATAGTAAGCA -> CCCACATTATAGTAAGCAA
AAGGAGTAGTGGAGCTTGT -> AGGAGTAGTGGAGCTTGTC
ACGCGCACGGCGTCCTGTG -> CGCGCACGGCGTCCTGTGT
TCCCGTGTCCTGTTACAAC -> CCCGTGTCCTGTTACAACC
AAGTCGGACTGGACGGCTC -> AGTCGGACTGGACGGCTCC
CGGAGGACTCAGTAATACC -> GGAGGACTCAGTAATACCG
AACATCCCCAGTTCGGATA -> ACATCCCCAGTTCGGATAC
AATTTTGAGGTCTGGGAGG -> ATTTTGAGGTCTGGGAGGG
CGGATACAAGGGATGTAAA -> GGATACAAGGGATGTAAAA
ACTTTCCTTGCCCCAACAT -> CTTTCCTTGCCCCAACATC
TGAACACGTATAAACTTTT -> GAACACGTATAAACTTTTA
AGGGGTCAGAACTAGGTTT -> GGGGTCAGAACTAGGTTTC
CGGCTCCCGAAAATACACA -> GGCTCCCGAAAATACACAC
GCATGTTGTTGACTCGTTC -> CATGTTGTTGACTCGTTCA
GGGGGATTGCCATGGTCTT -> GGGGATTGCCATGGTCTTA
ACTTTCAACGGCCACTGCA -> CTTTCAACGGCCACTGCAC
ATGTAATGCCACACGGGCT -> TGTAATGCCACACGGGCTT
GCCACGTAATTTCCATCAG -> CCACGTAATTTCCATCAGG
GCTCCTACTCAACTAAAAT -> CTCCTACTCAACTAAAATT
AGCGGCGATATAAGCGCGC -> GCGGCGATATAAGCGCGCG
GAGGACTCAGTAATACCGC -> AGGACTCAGTAATACCGCA
CGTTGATGTGCAAATTAGC -> GTTGATGTGCAAATTAGCG
CACTGCACTAGCCAGTGAG -> ACTGCACTAGCCAGTGAGC
AGAAAAGGGAACACTCCGC -> GAAAAGGGAACACTCCGCC
ACCTCCAGCGGTTAGAAAT -> CCTCCAGCGGTTAGAAATT
TCATGTTCCGCAACATATG -> CATGTTCCGCAACATATGC
AATGGTGGGACCCACTTGC -> ATGGTGGGACCCACTTGCA
ATAAGCGAGTGCCGCAATA -> TAAGCGAGTGCCGCAATAT
ATGGTCCGTGGCTGATCAC -> TGGTCCGTGGCTGATCACG
TAAGAAGTATGCCTTAGAC -> AAGAAGTATGCCTTAGACC
TTTTAACCTCCAGCGGTTA -> TTTAACCTCCAGCGGTTAG
TCGCCGTGCTTCATAGTCT -> CGCCGTGCTTCATAGTCTG
CGTTAGGTTCAGTAGAGCG -> GTTAGGTTCAGTAGAGCGG
CTGGACGGCTCCCGAAAAT -> TGGACGGCTCCCGAAAATA
GGAAGCTGTATGGCTAATT -> GAAGCTGTATGGCTAATTC
TTGAGAACACGAGGAAAGA -> TGAGAACACGAGGAAAGAC
CCCAACATCTTAGCTTCCT -> CCAACATCTTAGCTTCCTC
GAAGGTCCATGCAGGGCAG -> AAGGTCCATGCAGGGCAGC
TACCTCCAGCGGTTAGAAA -> ACCTCCAGCGGTTAGAAAT
ATGACCTTTCGCCGTGCTT -> TGACCTTTCGCCGTGCTTC
AACGAGACCGCGCATCTTA -> ACGAGACCGCGCATCTTAC
CGGACTGGACGGCTCCCGA -> GGACTGGACGGCTCCCGAA
GAATAAGCGAGTGCCGCAA -> AATAAGCGAGTGCCGCAAT
CCGCTCCTACTCAACTAAA -> CGCTCCTACTCAACTAAAA
CCATGGTCTTATGTAATGC -> CATGGTCTTATGTAATGCC
TAGGTTCAGTAGAGCGGAA -> AGGTTCAGTAGAGCGGAAA
CAGCGGCGATATAAGCGCG -> AGCGGCGATATAAGCGCGC
TAACCTCCAGCGGTTAGAA -> AACCTCCAGCGGTTAGAAA
AGACTGGTTATGGGGCCAA -> GACTGGTTATGGGGCCAAG
CTCTCCTTCTGGTTATTTA -> TCTCCTTCTGGTTATTTAG
CAGGATGCAGACTCCGTCA -> AGGATGCAGACTCCGTCAA
TGCTACTGGGGGATTGCCA -> GCTACTGGGGGATTGCCAT
CGGTTAGAAATTTTAAGTC -> GGTTAGAAATTTTAAGTCG
AGTTCCCCCATCTATTAAG -> GTTCCCCCATCTATTAAGC
ATACTGGACGGCTCCCGAA -> TACTGGACGGCTCCCGAAA
ACGAGTGTGCATGTTGTTG -> CGAGTGTGCATGTTGTTGA
CGAAAACACCAATACCGAT -> GAAAACACCAATACCGATA
GTGTGCATGTTGTTGACTC -> TGTGCATGTTGTTGACTCG
CTTACTTTCAACGGCCACT -> TTACTTTCAACGGCCACTG
TTAGCTCGTGTGGACCCGA -> TAGCTCGTGTGGACCCGAC
TGCCGCAATATGTGTAGGT -> GCCGCAATATGTGTAGGTC
TTCGCCGTGCTTCATAGTC -> TCGCCGTGCTTCATAGTCT
CTAAATCACTGCACTATAC -> TAAATCACTGCACTATACT
GGAGTAGTGGAGCTTGTCC -> GAGTAGTGGAGCTTGTCCG
GGAGAACCTACTGGTTCAT -> GAGAACCTACTGGTTCATG
TGCTAATACCTGTTGTGTA -> GCTAATACCTGTTGTGTAC
CGTTGTCACTTGGTACGAG -> GTTGTCACTTGGTACGAGT
GAAAAGGGAACACTCCGCC -> AAAAGGGAACACTCCGCCC
GGCTTCATGTTCCGCAACA -> GCTTCATGTTCCGCAACAT
GAGCTTGTCCGTGTAGTTC -> AGCTTGTCCGTGTAGTTCC
CTTAGCTTCCTCACCTAAT -> TTAGCTTCCTCACCTAATG
TGGCACGACGACGTCAAAA -> GGCACGACGACGTCAAAAT
ATTAAGCATTCCATCTGAA -> TTAAGCATTCCATCTGAAC
AGTATGCCTTAGACCTCCA -> GTATGCCTTAGACCTCCAG
CAACATCCCCAGTTCGGAT -> AACATCCCCAGTTCGGATA
ATGTTCCGCAACATATGCT -> TGTTCCGCAACATATGCTA
GATAGTGGTCGCTACAGTT -> ATAGTGGTCGCTACAGTTA
GAACACGTATAAACTTTTA -> AACACGTATAAACTTTTAT
CGTATAAACTTTTATGCTA -> GTATAAACTTTTATGCTAA
GTCCCTTCACCCACATTAT -> TCCCTTCACCCACATTATA
GCAAATTAGCGATATATAT -> CAAATTAGCGATATATATC
AATGAGCAACATCCCCAGT -> ATGAGCAACATCCCCAGTT
CGTCAAAATGGTGGGACCC -> GTCAAAATGGTGGGACCCA
GAAAGGCACATGCATACTG -> AAAGGCACATGCATACTGG
AGCCCGCCATGAGACTGGT -> GCCCGCCATGAGACTGGTT
TTCCTCACCTAATGAGCAA -> TCCTCACCTAATGAGCAAC
GAACAGCACTCGCAATGAA -> AACAGCACTCGCAATGAAG
TCACGATTTAGAGGTCCTA -> CACGATTTAGAGGTCCTAA
TCTGTCACGATTTAGAGGT -> CTGTCACGATTTAGAGGTC
ACTACTCCAGGGAAGCTGT -> CTACTCCAGGGAAGCTGTA
CCAAACCGTTGAGAACACG -> CAAACCGTTGAGAACACGA
GTTATTTAGGTATCTAAGG -> TTATTTAGGTATCTAAGGA
GTAAAACTGGCCGATACCT -> TAAAACTGGCCGATACCTT
CATTATTGGTTCAATGTCC -> ATTATTGGTTCAATGTCCC
AGCATTAGACCCCGACGGT -> GCATTAGACCCCGACGGTA
GGGATTGCCATGGTCTTAT -> GGATTGCCATGGTCTTATG
TTAGGTATCTAAGGAGTAG -> TAGGTATCTAAGGAGTAGT
CTGTCAGGGAACATCACAG -> TGTCAGGGAACATCACAGC
AGCAACATCCCCAGTTCGG -> GCAACATCCCCAGTTCGGA
AGTGAGCTACCAGTGGATC -> GTGAGCTACCAGTGGATCA
CTTGCCCCAACATCTTAGC -> TTGCCCCAACATCTTAGCT
CAGACTCCGTCAACCGACG -> AGACTCCGTCAACCGACGC
AGCAATGAGGACCAAGAAC -> GCAATGAGGACCAAGAACC
AACTAGCCTAGGTATTCGT -> ACTAGCCTAGGTATTCGTC
ATGAGGCTAGGAAGAACCG -> TGAGGCTAGGAAGAACCGC
TGCAGGGCAGCTTCCTTTT -> GCAGGGCAGCTTCCTTTTA
GGAAGAACCGCTCCTACTC -> GAAGAACCGCTCCTACTCA
TAGCGATATATATCGCGTT -> AGCGATATATATCGCGTTA
ACGTCAAAATGGTGGGACC -> CGTCAAAATGGTGGGACCC
GACGCCGCACGCTATGTTC -> ACGCCGCACGCTATGTTCG
GTAGTAGGGAGAACGAAGG -> TAGTAGGGAGAACGAAGGT
ATCCCGTTCTAGTATCATG -> TCCCGTTCTAGTATCATGG
TGCGACCCTCATCAAGTGC -> GCGACCCTCATCAAGTGCG
CCGTTCTAGTATCATGGGT -> CGTTCTAGTATCATGGGTG
AGCGGTTAGAAAACCGTTG -> GCGGTTAGAAAACCGTTGG
CTGCGTAATCCCGTGTCCT -> TGCGTAATCCCGTGTCCTG
TTAGGCCAGAGCTAAGTCC -> TAGGCCAGAGCTAAGTCCG
GACCACCTCCAGCGGTTAG -> ACCACCTCCAGCGGTTAGA
ATAAACTTTTATGCTAAAT -> TAAACTTTTATGCTAAATG
ACCACGACGGAGGACTCAG -> CCACGACGGAGGACTCAGT
GCATCTAGTTGGGAAAATC -> CATCTAGTTGGGAAAATCG
CAATGTCCCTTCACCCACA -> AATGTCCCTTCACCCACAT
CGTGGTACAATTTAATTTA -> GTGGTACAATTTAATTTAG
ACTATAGCGATAGTGGTCG -> CTATAGCGATAGTGGTCGC
CAGAGCTAAGTCCGAGAAC -> AGAGCTAAGTCCGAGAACC
GTGGCTGATCACGAGTATA -> TGGCTGATCACGAGTATAT
ACGGAGGACTCAGTAATAC -> CGGAGGACTCAGTAATACC
ACCCTCCAGCTACCTCCAG -> CCCTCCAGCTACCTCCAGC
GCGTAGTAGGGAGAACGAA -> CGTAGTAGGGAGAACGAAG
AACATCGGGCGTACTCTCC -> ACATCGGGCGTACTCTCCT
TTGATGTGCAAATTAGCGA -> TGATGTGCAAATTAGCGAT
ACCGATACAACCTTGATCA -> CCGATACAACCTTGATCAG
CAGTGAGCTACCAGTGGAT -> AGTGAGCTACCAGTGGATC
CCGTGCGACCCTCATCAAG -> CGTGCGACCCTCATCAAGT
ACCTCCAGCGGTTAGAAAA -> CCTCCAGCGGTTAGAAAAC
ACTAAAATTCTCGCCGTGC -> CTAAAATTCTCGCCGTGCT
CGGCTCCCGAAAACACCAA -> GGCTCCCGAAAACACCAAT
TGAGCTACCAGTGGATCAC -> GAGCTACCAGTGGATCACT
TTATGTAATGCCACACGGG -> TATGTAATGCCACACGGGC
AAGCATTAGGCCAGAGCTA -> AGCATTAGGCCAGAGCTAA
GCCGTGCTTTCCCAAGCTA -> CCGTGCTTTCCCAAGCTAG
GCACTAAATGACCTTTCGC -> CACTAAATGACCTTTCGCC
CAACTATAGCGATAGTGGT -> AACTATAGCGATAGTGGTC
GACGGTAATGGTCCGTGGC -> ACGGTAATGGTCCGTGGCT
AAAATCGACTAAATCACTG -> AAATCGACTAAATCACTGC
GATATTTTCGCGTTGTCAC -> ATATTTTCGCGTTGTCACT
AATGAGGACCAAGAACCGT -> ATGAGGACCAAGAACCGTG
TATCTAAGGAGTAGTGGAG -> ATCTAAGGAGTAGTGGAGC
ATCACGAGTATATTCAGCA -> TCACGAGTATATTCAGCAA
TTAGTGAACACGTATAAAC -> TAGTGAACACGTATAAACT
ATCAAGTGCGTGGTACAAT -> TCAAGTGCGTGGTACAATT
CGGGGGGCATCTAGTTGGG -> GGGGGGCATCTAGTTGGGA
CATCAAGTGCGTGGTACAA -> ATCAAGTGCGTGGTACAAT
TGAAGGGATCCGCTTTAGT -> GAAGGGATCCGCTTTAGTA
TCGCTACAGTTACCCGCAA -> CGCTACAGTTACCCGCAAC
AGGGCCCAAGCATTAGACC -> GGGCCCAAGCATTAGACCC
AAAATTCTCGCCGTGCTTT -> AAATTCTCGCCGTGCTTTC
CCCCGTGGCACGACGACGT -> CCCGTGGCACGACGACGTC
CTAAATGACCTTTCGCCGT -> TAAATGACCTTTCGCCGTG
AGCTAGATCAACTGTTTAG -> GCTAGATCAACTGTTTAGC
ATACTCTGGAATAAGCGAG -> TACTCTGGAATAAGCGAGT
CAACTGGACGGCTCCCGAA -> AACTGGACGGCTCCCGAAA
CGCACACCCCTGTTCAACT -> GCACACCCCTGTTCAACTA
GTGTAGGTCTTGGATCACA -> TGTAGGTCTTGGATCACAA
TGTTTTCAACTGGACGGCT -> GTTTTCAACTGGACGGCTC
GGGGTCAGAACTAGGTTTC -> GGGTCAGAACTAGGTTTCG
TACGACCCGGCTTCATGTT -> ACGACCCGGCTTCATGTTC
TCATATCGGCATGAGGCTA -> CATATCGGCATGAGGCTAG
ACTGGTTATGGGGCCAAGC -> CTGGTTATGGGGCCAAGCA
CAAGCATTAGGCCAGAGCT -> AAGCATTAGGCCAGAGCTA
TAAATGCCCTCGCGCACAC -> AAATGCCCTCGCGCACACC
TTAGGTTCAGTAGAGCGGA -> TAGGTTCAGTAGAGCGGAA
TGTCCGTGTAGTTCCTTGC -> GTCCGTGTAGTTCCTTGCT
ATAGCACGAGTGTGCATGT -> TAGCACGAGTGTGCATGTT
CGGATTGTGAGACCACCTC -> GGATTGTGAGACCACCTCC
ACCAGTGGATCACTAGGGT -> CCAGTGGATCACTAGGGTG
ACTACGACCCGGCTTCATG -> CTACGACCCGGCTTCATGT
CGGTAATGGTCCGTGGCTG -> GGTAATGGTCCGTGGCTGA
GCTGTATGGCTAATTCAGA -> CTGTATGGCTAATTCAGAG
GCATTAGGCCAGAGCTAAG -> CATTAGGCCAGAGCTAAGT
GCCACTGCACTAGCCAGTG -> CCACTGCACTAGCCAGTGA
TGCAGACTCCGTCAACCGA -> GCAGACTCCGTCAACCGAC
CACGAGTATATTCAGCAAG -> ACGAGTATATTCAGCAAGG
TCCGCTTTAGTAGCGTAGT -> CCGCTTTAGTAGCGTAGTA
ACCTACTGGTTCATGCGAT -> CCTACTGGTTCATGCGATA
ACGGCTCCCGAAAACACCA -> CGGCTCCCGAAAACACCAA
CACTTGGTACGAGTAACTT -> ACTTGGTACGAGTAACTTT
TTCAACTGGACGGCTCCCG -> TCAACTGGACGGCTCCCGA
CGTGTGGACCCGACCACGA -> GTGTGGACCCGACCACGAC
TCTAATGCATAAGTCACTT -> CTAATGCATAAGTCACTTG
AATGAAGGGATCCGCTTTA -> ATGAAGGGATCCGCTTTAG
GAGGCTAGGAAGAACCGCT -> AGGCTAGGAAGAACCGCTC
AGATCAACTGTTTAGCCGC -> GATCAACTGTTTAGCCGCC
CTTGGTGGGAGAAAAGGGA -> TTGGTGGGAGAAAAGGGAA
CGGATACTCTGGAATAAGC -> GGATACTCTGGAATAAGCG
TGGACGGCTCCCGAAAAAT -> GGACGGCTCCCGAAAAATT
TCCCCCATCTATTAAGCAT -> CCCCCATCTATTAAGCATT
AAAAAAACTGCGTAATCCC -> AAAAAACTGCGTAATCCCG
GCCACCCTCCAGCTACCTC -> CCACCCTCCAGCTACCTCC
ATAGCGATAGTGGTCGCTA -> TAGCGATAGTGGTCGCTAC
CCTGTTGTGTACTAGTGAA -> CTGTTGTGTACTAGTGAAA
CGCTTTAGTAGCGTAGTAG -> GCTTTAGTAGCGTAGTAGG
AGCAAGGATGCGTTGGGCA -> GCAAGGATGCGTTGGGCAA
AAAATGGTGGGACCCACTT -> AAATGGTGGGACCCACTTG
TCAACTATAGCGATAGTGG -> CAACTATAGCGATAGTGGT
CAGGAGCTCTGAAGCCCGC -> AGGAGCTCTGAAGCCCGCC
GTAACTTTCCTTGCCCCAA -> TAACTTTCCTTGCCCCAAC
GGAAAATCGACTAAATCAC -> GAAAATCGACTAAATCACT
GGCGTACTCTCCTTCTGGT -> GCGTACTCTCCTTCTGGTT
CGCCGTGCTTCATAGTCTG -> GCCGTGCTTCATAGTCTGG
GACACGCAAGCATTAGGCC -> ACACGCAAGCATTAGGCCA
CCCCAGTTCGGATACAAGG -> CCCAGTTCGGATACAAGGG
TGATGTGCAAATTAGCGAT -> GATGTGCAAATTAGCGATA
ATATCGGCATGAGGCTAGG -> TATCGGCATGAGGCTAGGA
TTTAAGTGAAATGCGCCTA -> TTAAGTGAAATGCGCCTAT
ACTGGGGCGGGGTCCTATC -> CTGGGGCGGGGTCCTATCT
AAGCATTCCATCTGAACAT -> AGCATTCCATCTGAACATC
GAAGCTCCAGACCTGGAAA -> AAGCTCCAGACCTGGAAAG
GTGCGACCCTCATCAAGTG -> TGCGACCCTCATCAAGTGC
TCACTTGGTACGAGTAACT -> CACTTGGTACGAGTAACTT
AGTAGGGAGAACGAAGGTC -> GTAGGGAGAACGAAGGTCC
GATTGCCATGGTCTTATGT -> ATTGCCATGGTCTTATGTA
GCCAGTGAGCTACCAGTGG -> CCAGTGAGCTACCAGTGGA
CTACTCAACTAAAATTCTC -> TACTCAACTAAAATTCTCG
AGCTAGTTTTAAGTGAAAT -> GCTAGTTTTAAGTGAAATG
CCATGAGACTGGTTATGGG -> CATGAGACTGGTTATGGGG
GTTCAATGTCCCTTCACCC -> TTCAATGTCCCTTCACCCA
CGCAGGAGCTCTGAAGCCC -> GCAGGAGCTCTGAAGCCCG
CAATTTAATTTAGTGAACA -> AATTTAATTTAGTGAACAC
CGACTAAATCACTGCACTA -> GACTAAATCACTGCACTAT
AATTCTCGCCGTGCTTTCC -> ATTCTCGCCGTGCTTTCCC
GTGCTTCATAGTCTGGAAG -> TGCTTCATAGTCTGGAAGG
TGGATCACAACGTTCTAAT -> GGATCACAACGTTCTAATG
CCAGTTCGGATACAAGGGA -> CAGTTCGGATACAAGGGAT
CAACGAGACCGCGCATCTT -> AACGAGACCGCGCATCTTA
ATACAACCTTGATCAGTGA -> TACAACCTTGATCAGTGAG
TGGTACAATTTAATTTAGT -> GGTACAATTTAATTTAGTG
AGCTACCAGTGGATCACTA -> GCTACCAGTGGATCACTAG
ACGGCTCCCGAAAATACAC -> CGGCTCCCGAAAATACACA
TAGTTCCCCCATCTATTAA -> AGTTCCCCCATCTATTAAG
CCCATCTATTAAGCATTCC -> CCATCTATTAAGCATTCCA
TGCGCCGCATGTTGTAGTT -> GCGCCGCATGTTGTAGTTC
GAAAAGAAGCTCCAGACCT -> AAAAGAAGCTCCAGACCTG
TATCGCGTTAGGTTCAGTA -> ATCGCGTTAGGTTCAGTAG
AAAGAAGTTCTTAGCTCGT -> AAGAAGTTCTTAGCTCGTG
TCCTTTTAACCTCCAGCGG -> CCTTTTAACCTCCAGCGGT
TGAAGCCCGCCATGAGACT -> GAAGCCCGCCATGAGACTG
CGAGTAACTTTCCTTGCCC -> GAGTAACTTTCCTTGCCCC
ACTCCGTCAACCGACGCCG -> CTCCGTCAACCGACGCCGC
TTCAGAGCTAGTTTTAAGT -> TCAGAGCTAGTTTTAAGTG
AGTGAAATGCGCCTATCGG -> GTGAAATGCGCCTATCGGA
ATCAGTGAGGGGTCAGAAC -> TCAGTGAGGGGTCAGAACT
TTATCGTCAACTACAGCAA -> TATCGTCAACTACAGCAAT
TACTCTGGAATAAGCGAGT -> ACTCTGGAATAAGCGAGTG
AGGTATTCGTCAGCTTCAT -> GGTATTCGTCAGCTTCATT
GGAGCTCTGAAGCCCGCCA -> GAGCTCTGAAGCCCGCCAT
TGCTAAATGCCCTCGCGCA -> GCTAAATGCCCTCGCGCAC
AATTAGCGATATATATCGC -> ATTAGCGATATATATCGCG
CGCTCCTACTCAACTAAAA -> GCTCCTACTCAACTAAAAT
TTGCTGAAATCTTTAGCCG -> TGCTGAAATCTTTAGCCGA
TGAAAAGAAGCTCCAGACC -> GAAAAGAAGCTCCAGACCT
TAACTGAAAGAAGTTCTTA -> AACTGAAAGAAGTTCTTAG
GGGCCCAAGCATTAGACCC -> GGCCCAAGCATTAGACCCC
GCTCCAGACCTGGAAAGGG -> CTCCAGACCTGGAAAGGGC
ACCGACGCCGCACGCTATG -> CCGACGCCGCACGCTATGT
ACATAGCACGAGTGTGCAT -> CATAGCACGAGTGTGCATG
ACTTGGTACGAGTAACTTT -> CTTGGTACGAGTAACTTTC
TCGCGCACACCCCTGTTCA -> CGCGCACACCCCTGTTCAA
AATGACCTTTCGCCGTGCT -> ATGACCTTTCGCCGTGCTT
GTACTCTCCTTCTGGTTAT -> TACTCTCCTTCTGGTTATT
TAGTGGAGCTTGTCCGTGT -> AGTGGAGCTTGTCCGTGTA
AGTCACTTGTGATCCCGTT -> GTCACTTGTGATCCCGTTC
ACAATTTAATTTAGTGAAC -> CAATTTAATTTAGTGAACA
CTCCAGCGGTTAGAAATTT -> TCCAGCGGTTAGAAATTTT
CCGCGCATCTTACTTTCAA -> CGCGCATCTTACTTTCAAC
ACCTCTTTGCTAATACCTG -> CCTCTTTGCTAATACCTGT
GCCTAGGTATTCGTCAGCT -> CCTAGGTATTCGTCAGCTT
CCTCATCAAGTGCGTGGTA -> CTCATCAAGTGCGTGGTAC
GCTTGTCCGTGTAGTTCCT -> CTTGTCCGTGTAGTTCCTT
TGTGAGACCACCTCCAGCG -> GTGAGACCACCTCCAGCGG
GCCGACCTTACGGATTGTG -> CCGACCTTACGGATTGTGA
TATAAACTTTTATGCTAAA -> ATAAACTTTTATGCTAAAT
TAGCGATAGTGGTCGCTAC -> AGCGATAGTGGTCGCTACA
CTCCAGCTACCTCCAGCGG -> TCCAGCTACCTCCAGCGGT
TTATTGGTTCAATGTCCCT -> TATTGGTTCAATGTCCCTT
GAGTGTGCATGTTGTTGAC -> AGTGTGCATGTTGTTGACT
CTCTGGTACGGATACTCTG -> TCTGGTACGGATACTCTGG
GACAGGCATGACCAGGCTC -> ACAGGCATGACCAGGCTCT
TACTCCAGGGAAGCTGTAT -> ACTCCAGGGAAGCTGTATG
TCGTCAACTACAGCAATGA -> CGTCAACTACAGCAATGAG
CGGACTGGCACTAAATGAC -> GGACTGGCACTAAATGACC
AGGTCTTGGATCACAACGT -> GGTCTTGGATCACAACGTT
TGGGAGGGGAGAACCTACT -> GGGAGGGGAGAACCTACTG
GGAGAAAAGGGAACACTCC -> GAGAAAAGGGAACACTCCG
ACTAGCCAGTGAGCTACCA -> CTAGCCAGTGAGCTACCAG
CACGCAAGCATTAGGCCAG -> ACGCAAGCATTAGGCCAGA
GTATCATGGGTGTGCGCCG -> TATCATGGGTGTGCGCCGC
TTAGACCTCCAGCGGTTAG -> TAGACCTCCAGCGGTTAGA
TATCATGGGTGTGCGCCGC -> ATCATGGGTGTGCGCCGCA
CCTACTGGTTCATGCGATA -> CTACTGGTTCATGCGATAT
ACACCCATACATAGCACGA -> CACCCATACATAGCACGAG
TGTATGGCTAATTCAGAGC -> GTATGGCTAATTCAGAGCT
TGTTCGCAGGAGCTCTGAA -> GTTCGCAGGAGCTCTGAAG
GGGGCGGGGTCCTATCTCA -> GGGCGGGGTCCTATCTCAG
TGCATACTGGACGGCTCCC -> GCATACTGGACGGCTCCCG
ATCACAACGTTCTAATGCA -> TCACAACGTTCTAATGCAT
TAGAAAACCGTTGGGTGAC -> AGAAAACCGTTGGGTGACT
AATGGTCCGTGGCTGATCA -> ATGGTCCGTGGCTGATCAC
AGCGGTTAGAAACGGTGTT -> GCGGTTAGAAACGGTGTTT
TTACCCGCAACTACGACCC -> TACCCGCAACTACGACCCG
GTGTACTAGTGAAAAGAAG -> TGTACTAGTGAAAAGAAGC
GTTGGGTGACTGGACGGCT -> TTGGGTGACTGGACGGCTC
ATCGACTAAATCACTGCAC -> TCGACTAAATCACTGCACT
ACAGCAATGAGGACCAAGA -> CAGCAATGAGGACCAAGAA
TTTTGAGGTCTGGGAGGGG -> TTTGAGGTCTGGGAGGGGA
GTTTTAAGTGAAATGCGCC -> TTTTAAGTGAAATGCGCCT
TACAACCTTGATCAGTGAG -> ACAACCTTGATCAGTGAGG
GGAAAGGGCCCAAGCATTA -> GAAAGGGCCCAAGCATTAG
ACTAAATCACTGCACTATA -> CTAAATCACTGCACTATAC
CGCCTACTACTCCAGGGAA -> GCCTACTACTCCAGGGAAG
CACACGGGCTTTTAACTGA -> ACACGGGCTTTTAACTGAA
CTATACTCGCGGCCCAAAC -> TATACTCGCGGCCCAAACC
TCCGTCAACCGACGCCGCA -> CCGTCAACCGACGCCGCAC
GATCCCGTTCTAGTATCAT -> ATCCCGTTCTAGTATCATG
TTCGTCAGCTTCATTATTG -> TCGTCAGCTTCATTATTGG
ATGGGGCCAAGCAGTTGCT -> TGGGGCCAAGCAGTTGCTG
CCCGTGGCACGACGACGTC -> CCGTGGCACGACGACGTCA
CCGAAAACTACTGTCAGGG -> CGAAAACTACTGTCAGGGA
GAAATTTTAAGTCGGACTG -> AAATTTTAAGTCGGACTGG
ACTGGTTCATGCGATATTT -> CTGGTTCATGCGATATTTT
TTAGCTTCCTCACCTAATG -> TAGCTTCCTCACCTAATGA
TTCAATGTCCCTTCACCCA -> TCAATGTCCCTTCACCCAC
CTTGCATCCAGCGGCGATA -> TTGCATCCAGCGGCGATAT
GCATGAGGCTAGGAAGAAC -> CATGAGGCTAGGAAGAACC
GCTTCATTATTGGTTCAAT -> CTTCATTATTGGTTCAATG
ATGAGGACCAAGAACCGTG -> TGAGGACCAAGAACCGTGC
AGGGATGTAAAACTGGCCG -> GGGATGTAAAACTGGCCGA
TATGTGTAGGTCTTGGATC -> ATGTGTAGGTCTTGGATCA
TCTAGTTGGGAAAATCGAC -> CTAGTTGGGAAAATCGACT
GCTCCCGAAAATACACACC -> CTCCCGAAAATACACACCC
ACGGTGTTTTCAACTGGAC -> CGGTGTTTTCAACTGGACG
AAACCGTTGGGTGACTGGA -> AACCGTTGGGTGACTGGAC
TTCATAGTCTGGAAGGCAA -> TCATAGTCTGGAAGGCAAC
AGTTTTAAGTGAAATGCGC -> GTTTTAAGTGAAATGCGCC
CTTTGCTAATACCTGTTGT -> TTTGCTAATACCTGTTGTG
GACTAAATCACTGCACTAT -> ACTAAATCACTGCACTATA
TCTTATGTAATGCCACACG -> CTTATGTAATGCCACACGG
GTGTGCGCCGCATGTTGTA -> TGTGCGCCGCATGTTGTAG
ACTAGGTTTCGACCGGGGG -> CTAGGTTTCGACCGGGGGG
GTGGTCGCTACAGTTACCC -> TGGTCGCTACAGTTACCCG
TTTTAACTGAAAGAAGTTC -> TTTAACTGAAAGAAGTTCT
GTCCATGCAGGGCAGCTTC -> TCCATGCAGGGCAGCTTCC
AAGTTCTTAGCTCGTGTGG -> AGTTCTTAGCTCGTGTGGA
ATTTAGAGGTCCTAACCAG -> TTTAGAGGTCCTAACCAGG
ATACACACCCATACATAGC -> TACACACCCATACATAGCA
GAGCTAGTTTTAAGTGAAA -> AGCTAGTTTTAAGTGAAAT
GTTGGGAAAATCGACTAAA -> TTGGGAAAATCGACTAAAT
AAGTGCGTGGTACAATTTA -> AGTGCGTGGTACAATTTAA
CAGCGTCATATCGGCATGA -> AGCGTCATATCGGCATGAG
AGTTACCCGCAACTACGAC -> GTTACCCGCAACTACGACC
GGGCATCTAGTTGGGAAAA -> GGCATCTAGTTGGGAAAAT
TCATGGGTGTGCGCCGCAT -> CATGGGTGTGCGCCGCATG
CCAAGAACCGTGCGACCCT -> CAAGAACCGTGCGACCCTC
GTGTTTTCAACTGGACGGC -> TGTTTTCAACTGGACGGCT
TGGCACTAAATGACCTTTC -> GGCACTAAATGACCTTTCG
GTCTGGGAGGGGAGAACCT -> TCTGGGAGGGGAGAACCTA
CGACCCGGCTTCATGTTCC -> GACCCGGCTTCATGTTCCG
TATGCTAAGCTAATGATCC -> ATGCTAAGCTAATGATCCG
GTTCCCCCATCTATTAAGC -> TTCCCCCATCTATTAAGCA
TTCCCCCATCTATTAAGCA -> TCCCCCATCTATTAAGCAT
GGCTCCCGAAAACTACTGT -> GCTCCCGAAAACTACTGTC
TCGTCAGCTTCATTATTGG -> CGTCAGCTTCATTATTGGT
ATCTAGTTGGGAAAATCGA -> TCTAGTTGGGAAAATCGAC
CCACACGGGCTTTTAACTG -> CACACGGGCTTTTAACTGA
GGTCCTATCTCAGAACTGA -> GTCCTATCTCAGAACTGAC
CCTTGATCAGTGAGGGGTC -> CTTGATCAGTGAGGGGTCA
ACCTTACGGATTGTGAGAC -> CCTTACGGATTGTGAGACC
CGCTATGTTCGCAGGAGCT -> GCTATGTTCGCAGGAGCTC
GCCCAAACCGTTGAGAACA -> CCCAAACCGTTGAGAACAC
GCCCGCCATGAGACTGGTT -> CCCGCCATGAGACTGGTTA
AGTATCATGGGTGTGCGCC -> GTATCATGGGTGTGCGCCG
CGCAAGCATTAGGCCAGAG -> GCAAGCATTAGGCCAGAGC
GTTAGAAAGGCACATGCAT -> TTAGAAAGGCACATGCATA
CGGCTCCCGAAAAATTTTG -> GGCTCCCGAAAAATTTTGA
GGGATGCCACGTAATTTCC -> GGATGCCACGTAATTTCCA
TGTAAAACTGGCCGATACC -> GTAAAACTGGCCGATACCT
GCAACATCCCCAGTTCGGA -> CAACATCCCCAGTTCGGAT
AGCGATGAACAGCACTCGC -> GCGATGAACAGCACTCGCA
CAAAATGGTGGGACCCACT -> AAAATGGTGGGACCCACTT
AGGAAGAACCGCTCCTACT -> GGAAGAACCGCTCCTACTC
GCAAGGGGATGCCACGTAA -> CAAGGGGATGCCACGTAAT
GATCAGTGAGGGGTCAGAA -> ATCAGTGAGGGGTCAGAAC
CTAATTCAGAGCTAGTTTT -> TAATTCAGAGCTAGTTTTA
GGTTATGGGGCCAAGCAGT -> GTTATGGGGCCAAGCAGTT
ACTACAGCAATGAGGACCA -> CTACAGCAATGAGGACCAA
CCGATACCTTGGTGGGAGA -> CGATACCTTGGTGGGAGAA
TTTAGTAGCGTAGTAGGGA -> TTAGTAGCGTAGTAGGGAG
AAAAGAATGAGAAAAAAAC -> AAAGAATGAGAAAAAAACT
CGCGCACGGCGTCCTGTGT -> GCGCACGGCGTCCTGTGTT
GGCTCCCGAAAAATTTTGA -> GCTCCCGAAAAATTTTGAG
CCCAAGCATTAGACCCCGA -> CCAAGCATTAGACCCCGAC
GCTACCAGTGGATCACTAG -> CTACCAGTGGATCACTAGG
CGTGTAGTTCCTTGCTACT -> GTGTAGTTCCTTGCTACTG
AGGCATGACCAGGCTCTGG -> GGCATGACCAGGCTCTGGT
CGCACGGCGTCCTGTGTTA -> GCACGGCGTCCTGTGTTAT
GCTCTGAAGCCCGCCATGA -> CTCTGAAGCCCGCCATGAG
TACAATTTAATTTAGTGAA -> ACAATTTAATTTAGTGAAC
GTAGCGTAGTAGGGAGAAC -> TAGCGTAGTAGGGAGAACG
AAATGTCCCCGTGGCACGA -> AATGTCCCCGTGGCACGAC
TGAAATGCGCCTATCGGAC -> GAAATGCGCCTATCGGACT
TACTTTCAACGGCCACTGC -> ACTTTCAACGGCCACTGCA
ACCAGGATGCAGACTCCGT -> CCAGGATGCAGACTCCGTC
CCCGAAAATACACACCCAT -> CCGAAAATACACACCCATA
TCACAACGTTCTAATGCAT -> CACAACGTTCTAATGCATA
TTGTCACTTGGTACGAGTA -> TGTCACTTGGTACGAGTAA
ACTCCGCCCCTCTTTTCCC -> CTCCGCCCCTCTTTTCCCC
CCTCACCTAATGAGCAACA -> CTCACCTAATGAGCAACAT
CGTGCGACCCTCATCAAGT -> GTGCGACCCTCATCAAGTG
CTGAGTTCCATCTGTCACG -> TGAGTTCCATCTGTCACGA
AGCCACCCTCCAGCTACCT -> GCCACCCTCCAGCTACCTC
GGACGGCTCCCGAAAATAC -> GACGGCTCCCGAAAATACA
CTGCACTAGCCAGTGAGCT -> TGCACTAGCCAGTGAGCTA
GTTGACTCGTTCAGACTGG -> TTGACTCGTTCAGACTGGG
TTAGACCCCGACGGTAATG -> TAGACCCCGACGGTAATGG
GCTAAGCTAATGATCCGAG -> CTAAGCTAATGATCCGAGC
GGTTTCGACCGGGGGGCAT -> GTTTCGACCGGGGGGCATC
AGTATATTCAGCAAGGATG -> GTATATTCAGCAAGGATGC
GACCGGACTGGCACTAAAT -> ACCGGACTGGCACTAAATG
ACTCTGGAATAAGCGAGTG -> CTCTGGAATAAGCGAGTGC
GCGATATTTTCGCGTTGTC -> CGATATTTTCGCGTTGTCA
AGCTCTGAAGCCCGCCATG -> GCTCTGAAGCCCGCCATGA
GGCATGAGGCTAGGAAGAA -> GCATGAGGCTAGGAAGAAC
ATTCGTCAGCTTCATTATT -> TTCGTCAGCTTCATTATTG
TTAGAAAGGCACATGCATA -> TAGAAAGGCACATGCATAC
CAGCAAGGATGCGTTGGGC -> AGCAAGGATGCGTTGGGCA
AAATTCTCGCCGTGCTTTC -> AATTCTCGCCGTGCTTTCC
CTTCCTCACCTAATGAGCA -> TTCCTCACCTAATGAGCAA
CACTATACTCGCGGCCCAA -> ACTATACTCGCGGCCCAAA
GAATGAGAAAAAAACTGCG -> AATGAGAAAAAAACTGCGT
AACTGAAAGAAGTTCTTAG -> ACTGAAAGAAGTTCTTAGC
TGGGTGACTGGACGGCTCC -> GGGTGACTGGACGGCTCCC
CAGCTACCTCCAGCGGTTA -> AGCTACCTCCAGCGGTTAG
CTAACCAGGATGCAGACTC -> TAACCAGGATGCAGACTCC
ATCTTAGCTTCCTCACCTA -> TCTTAGCTTCCTCACCTAA
AGAATGAGAAAAAAACTGC -> GAATGAGAAAAAAACTGCG
ATACCTTGGTGGGAGAAAA -> TACCTTGGTGGGAGAAAAG
GACCCCGACGGTAATGGTC -> ACCCCGACGGTAATGGTCC
ACTAGCCTAGGTATTCGTC -> CTAGCCTAGGTATTCGTCA
CGCCATGAGACTGGTTATG -> GCCATGAGACTGGTTATGG
TGCATAAGTCACTTGTGAT -> GCATAAGTCACTTGTGATC
GGTCAGAACTAGGTTTCGA -> GTCAGAACTAGGTTTCGAC
CATGTTCCGCAACATATGC -> ATGTTCCGCAACATATGCT
CAAGAACCGTGCGACCCTC -> AAGAACCGTGCGACCCTCA
AAATGACCTTTCGCCGTGC -> AATGACCTTTCGCCGTGCT
CACGGGCTTTTAACTGAAA -> ACGGGCTTTTAACTGAAAG
GCCCTCGCGCACACCCCTG -> CCCTCGCGCACACCCCTGT
TTTAACTGAAAGAAGTTCT -> TTAACTGAAAGAAGTTCTT
GCGTGGTACAATTTAATTT -> CGTGGTACAATTTAATTTA
GTCATATCGGCATGAGGCT -> TCATATCGGCATGAGGCTA
ACATCCCCAGTTCGGATAC -> CATCCCCAGTTCGGATACA
GGGGCCAAGCAGTTGCTGA -> GGGCCAAGCAGTTGCTGAA
GGTCTTGGATCACAACGTT -> GTCTTGGATCACAACGTTC
AGCACTCGCAATGAAGGGA -> GCACTCGCAATGAAGGGAT
GCCCAAGCATTAGACCCCG -> CCCAAGCATTAGACCCCGA
GGCCACTGCACTAGCCAGT -> GCCACTGCACTAGCCAGTG
CCTCCAGCGGTTAGAAATT -> CTCCAGCGGTTAGAAATTT
TGTGTACTAGTGAAAAGAA -> GTGTACTAGTGAAAAGAAG
ACACCAATACCGATACAAC -> CACCAATACCGATACAACC
GTAGAGCGGAAAAGAATGA -> TAGAGCGGAAAAGAATGAG
AACGAAGGTCCATGCAGGG -> ACGAAGGTCCATGCAGGGC
TGTGCGCCGCATGTTGTAG -> GTGCGCCGCATGTTGTAGT
CGTGCTTTCCCAAGCTAGA -> GTGCTTTCCCAAGCTAGAT
CAATGAGGACCAAGAACCG -> AATGAGGACCAAGAACCGT
GGTTAGAAAACCGTTGGGT -> GTTAGAAAACCGTTGGGTG
CCCTCCAGCTACCTCCAGC -> CCTCCAGCTACCTCCAGCG
TGTCAGGGAACATCACAGC -> GTCAGGGAACATCACAGCG
GGCAGCTTCCTTTTAACCT -> GCAGCTTCCTTTTAACCTC
GGCTCTGGTACGGATACTC -> GCTCTGGTACGGATACTCT
GAACGAAGGTCCATGCAGG -> AACGAAGGTCCATGCAGGG
CATCTTAGCTTCCTCACCT -> ATCTTAGCTTCCTCACCTA
GAGACTGGTTATGGGGCCA -> AGACTGGTTATGGGGCCAA
ATTTAGTGAACACGTATAA -> TTTAGTGAACACGTATAAA
TCGTGTGGACCCGACCACG -> CGTGTGGACCCGACCACGA
CGTTGGGCAAGGGGATGCC -> GTTGGGCAAGGGGATGCCA
AATACCTGTTGTGTACTAG -> ATACCTGTTGTGTACTAGT
ACGTAATTTCCATCAGGCG -> CGTAATTTCCATCAGGCGA
GCGCGTAGTGACACGCAAG -> CGCGTAGTGACACGCAAGC
ACGGGCTTTTAACTGAAAG -> CGGGCTTTTAACTGAAAGA
CTGTTCAACTATAGCGATA -> TGTTCAACTATAGCGATAG
TATTAAGCATTCCATCTGA -> ATTAAGCATTCCATCTGAA
CTGGTTATGGGGCCAAGCA -> TGGTTATGGGGCCAAGCAG
GAGACCGCGCATCTTACTT -> AGACCGCGCATCTTACTTT
TAATGCCACACGGGCTTTT -> AATGCCACACGGGCTTTTA
CTTTCGCCGTGCTTCATAG -> TTTCGCCGTGCTTCATAGT
TGCCCCAACATCTTAGCTT -> GCCCCAACATCTTAGCTTC
TGTCACGATTTAGAGGTCC -> GTCACGATTTAGAGGTCCT
CGTAGTAGGGAGAACGAAG -> GTAGTAGGGAGAACGAAGG
AAATGCCCTCGCGCACACC -> AATGCCCTCGCGCACACCC
AAGTATGCCTTAGACCTCC -> AGTATGCCTTAGACCTCCA
ACCTGTTGTGTACTAGTGA -> CCTGTTGTGTACTAGTGAA
CAATACCGATACAACCTTG -> AATACCGATACAACCTTGA
GTGAACACGTATAAACTTT -> TGAACACGTATAAACTTTT
GATTGTGAGACCACCTCCA -> ATTGTGAGACCACCTCCAG
GGATCCGCTTTAGTAGCGT -> GATCCGCTTTAGTAGCGTA
GGGAGAAAAGGGAACACTC -> GGAGAAAAGGGAACACTCC
TGGTACGGATACTCTGGAA -> GGTACGGATACTCTGGAAT
GCAATGAAGGGATCCGCTT -> CAATGAAGGGATCCGCTTT
GCCAGAGCTAAGTCCGAGA -> CCAGAGCTAAGTCCGAGAA
GAAGTTCTTAGCTCGTGTG -> AAGTTCTTAGCTCGTGTGG
TTACAACCCACCTAAGAAG -> TACAACCCACCTAAGAAGT
ACTGCACTAGCCAGTGAGC -> CTGCACTAGCCAGTGAGCT
CATAAGTCACTTGTGATCC -> ATAAGTCACTTGTGATCCC
ACTGGACGGCTCCCGAAAA -> CTGGACGGCTCCCGAAAAT,CTGGACGGCTCCCGAAAAA,CTGGACGGCTCCCGAAAAC,CTGGACGGCTCCCGAAAAC
TACATAGCACGAGTGTGCA -> ACATAGCACGAGTGTGCAT
CAGGCATGACCAGGCTCTG -> AGGCATGACCAGGCTCTGG
CATACTGGACGGCTCCCGA -> ATACTGGACGGCTCCCGAA
GCGATATAAGCGCGCGTAG -> CGATATAAGCGCGCGTAGT
AACCTACTGGTTCATGCGA -> ACCTACTGGTTCATGCGAT
GTAGGTCTTGGATCACAAC -> TAGGTCTTGGATCACAACG
CAACTAGCCTAGGTATTCG -> AACTAGCCTAGGTATTCGT
GAGAACCTGAGTTCCATCT -> AGAACCTGAGTTCCATCTG
TCGGATACAAGGGATGTAA -> CGGATACAAGGGATGTAAA
TAATACCGCACACACGCGC -> AATACCGCACACACGCGCA
GAGCAACATCCCCAGTTCG -> AGCAACATCCCCAGTTCGG
TTTAACCTCCAGCGGTTAG -> TTAACCTCCAGCGGTTAGA
TAGTATCATGGGTGTGCGC -> AGTATCATGGGTGTGCGCC
CTTATGTAATGCCACACGG -> TTATGTAATGCCACACGGG
TCACTGCACTATACTCGCG -> CACTGCACTATACTCGCGG
TTCATGCGATATTTTCGCG -> TCATGCGATATTTTCGCGT
CTAGTGAAAAGAAGCTCCA -> TAGTGAAAAGAAGCTCCAG
GTAATTTCCATCAGGCGAG -> TAATTTCCATCAGGCGAGC
GGCGGGGTCCTATCTCAGA -> GCGGGGTCCTATCTCAGAA
ACCGTTGAGAACACGAGGA -> CCGTTGAGAACACGAGGAA
GTCAGCTTCATTATTGGTT -> TCAGCTTCATTATTGGTTC
ACCCATACATAGCACGAGT -> CCCATACATAGCACGAGTG
TGACTGGACGGCTCCCGAA -> GACTGGACGGCTCCCGAAA
CTCCCGAAAACTACTGTCA -> TCCCGAAAACTACTGTCAG
GCTATGTTCGCAGGAGCTC -> CTATGTTCGCAGGAGCTCT
GACTGGTTATGGGGCCAAG -> ACTGGTTATGGGGCCAAGC
CTACTGTCAGGGAACATCA -> TACTGTCAGGGAACATCAC
CTTGCTACTGGGGGATTGC -> TTGCTACTGGGGGATTGCC
TCCTGTTACAACCCACCTA -> CCTGTTACAACCCACCTAA
CCTGTTACAACCCACCTAA -> CTGTTACAACCCACCTAAG
CGCTACAGTTACCCGCAAC -> GCTACAGTTACCCGCAACT
CCTAAGAAGTATGCCTTAG -> CTAAGAAGTATGCCTTAGA
AACTGCGTAATCCCGTGTC -> ACTGCGTAATCCCGTGTCC
CGGTTAGAAAACCGTTGGG -> GGTTAGAAAACCGTTGGGT
GGGGAGAACCTACTGGTTC -> GGGAGAACCTACTGGTTCA
TTAAGCATTCCATCTGAAC -> TAAGCATTCCATCTGAACA
CCGGCTTCATGTTCCGCAA -> CGGCTTCATGTTCCGCAAC
AATGCATAAGTCACTTGTG -> ATGCATAAGTCACTTGTGA
CTCGTTCAGACTGGGGCGG -> TCGTTCAGACTGGGGCGGG
CAGAGCTAGTTTTAAGTGA -> AGAGCTAGTTTTAAGTGAA
ACTCGTTCAGACTGGGGCG -> CTCGTTCAGACTGGGGCGG
ACGCCGCACGCTATGTTCG -> CGCCGCACGCTATGTTCGC
ATGTTGTTGACTCGTTCAG -> TGTTGTTGACTCGTTCAGA
TAAAATTCTCGCCGTGCTT -> AAAATTCTCGCCGTGCTTT
GGACTGGACGGCTCCCGAA -> GACTGGACGGCTCCCGAAA
CGCGTAGTGACACGCAAGC -> GCGTAGTGACACGCAAGCA
TAGCTTCCTCACCTAATGA -> AGCTTCCTCACCTAATGAG
ATGCTAAGCTAATGATCCG -> TGCTAAGCTAATGATCCGA
GGTAATGGTCCGTGGCTGA -> GTAATGGTCCGTGGCTGAT
ACACGCAAGCATTAGGCCA -> CACGCAAGCATTAGGCCAG
TGTAGGTCTTGGATCACAA -> GTAGGTCTTGGATCACAAC
TGGAAAGGGCCCAAGCATT -> GGAAAGGGCCCAAGCATTA
CCCTGTTCAACTATAGCGA -> CCTGTTCAACTATAGCGAT
GGATGCAGACTCCGTCAAC -> GATGCAGACTCCGTCAACC
TAATTCAGAGCTAGTTTTA -> AATTCAGAGCTAGTTTTAA
CGCAATATGTGTAGGTCTT -> GCAATATGTGTAGGTCTTG
AGTAGCGTAGTAGGGAGAA -> GTAGCGTAGTAGGGAGAAC
CCACGACGGAGGACTCAGT -> CACGACGGAGGACTCAGTA
TTTAAGTCGGACTGGACGG -> TTAAGTCGGACTGGACGGC
TAATGAGCAACATCCCCAG -> AATGAGCAACATCCCCAGT
ACTCCAAATGTCCCCGTGG -> CTCCAAATGTCCCCGTGGC
GCATCTTACTTTCAACGGC -> CATCTTACTTTCAACGGCC
GCCGATACCTTGGTGGGAG -> CCGATACCTTGGTGGGAGA
CCAGTGAGCTACCAGTGGA -> CAGTGAGCTACCAGTGGAT
CTATTAAGCATTCCATCTG -> TATTAAGCATTCCATCTGA
CGCGCACACCCCTGTTCAA -> GCGCACACCCCTGTTCAAC
ACTGTTTAGCCGCCTACTA -> CTGTTTAGCCGCCTACTAC
CCAACATCTTAGCTTCCTC -> CAACATCTTAGCTTCCTCA
AGTAGAGCGGAAAAGAATG -> GTAGAGCGGAAAAGAATGA
TCACGAGTATATTCAGCAA -> CACGAGTATATTCAGCAAG
GGTCCTAACCAGGATGCAG -> GTCCTAACCAGGATGCAGA
CGTAGTGACACGCAAGCAT -> GTAGTGACACGCAAGCATT
GAGGGGTCAGAACTAGGTT -> AGGGGTCAGAACTAGGTTT
AGCCAGTGAGCTACCAGTG -> GCCAGTGAGCTACCAGTGG
AAGTCCGAGAACCTGAGTT -> AGTCCGAGAACCTGAGTTC
GGAATAAGCGAGTGCCGCA -> GAATAAGCGAGTGCCGCAA
AGAACCGTGCGACCCTCAT -> GAACCGTGCGACCCTCATC
TCACAGCGTCATATCGGCA -> CACAGCGTCATATCGGCAT
TCAACTAAAATTCTCGCCG -> CAACTAAAATTCTCGCCGT
CCCGAAAAATTTTGAGGTC -> CCGAAAAATTTTGAGGTCT
GAGAACCTACTGGTTCATG -> AGAACCTACTGGTTCATGC
GTGCCGCAATATGTGTAGG -> TGCCGCAATATGTGTAGGT
AGCGTAGTAGGGAGAACGA -> GCGTAGTAGGGAGAACGAA
AACTAAAATTCTCGCCGTG -> ACTAAAATTCTCGCCGTGC
TCACTTGTGATCCCGTTCT -> CACTTGTGATCCCGTTCTA
GACGGCTCCCGAAAACACC -> ACGGCTCCCGAAAACACCA
TTTCAACGGCCACTGCACT -> TTCAACGGCCACTGCACTA
ATGCAGGGCAGCTTCCTTT -> TGCAGGGCAGCTTCCTTTT
AACACCAATACCGATACAA -> ACACCAATACCGATACAAC
GGACGGCTCCCGAAAACAC -> GACGGCTCCCGAAAACACC
TAGCGTAGTAGGGAGAACG -> AGCGTAGTAGGGAGAACGA
ATACTCGCGGCCCAAACCG -> TACTCGCGGCCCAAACCGT
GTTCAACTATAGCGATAGT -> TTCAACTATAGCGATAGTG
GTAGTTCCTTGCTACTGGG -> TAGTTCCTTGCTACTGGGG
TACCGCACACACGCGCACG -> ACCGCACACACGCGCACGG
CCTACTCAACTAAAATTCT -> CTACTCAACTAAAATTCTC
ACAGTTACCCGCAACTACG -> CAGTTACCCGCAACTACGA
TGTCCCTTCACCCACATTA -> GTCCCTTCACCCACATTAT
CTGTGTTATCGTCAACTAC -> TGTGTTATCGTCAACTACA
CTCTGGAATAAGCGAGTGC -> TCTGGAATAAGCGAGTGCC
TTCCATCTGTCACGATTTA -> TCCATCTGTCACGATTTAG
TACGGATACTCTGGAATAA -> ACGGATACTCTGGAATAAG
AGAACGAAGGTCCATGCAG -> GAACGAAGGTCCATGCAGG
GCGTAATCCCGTGTCCTGT -> CGTAATCCCGTGTCCTGTT
CTGATCACGAGTATATTCA -> TGATCACGAGTATATTCAG
TTTCCATCAGGCGAGCGAT -> TTCCATCAGGCGAGCGATG
ATGTCCCCGTGGCACGACG -> TGTCCCCGTGGCACGACGA
CACACGCGCACGGCGTCCT -> ACACGCGCACGGCGTCCTG
GCCCCTCTTTTCCCCAGGA -> CCCCTCTTTTCCCCAGGAC
GAGACCACCTCCAGCGGTT -> AGACCACCTCCAGCGGTTA
CTAAAATTCTCGCCGTGCT -> TAAAATTCTCGCCGTGCTT
TTAAGTCGGACTGGACGGC -> TAAGTCGGACTGGACGGCT
ATTATAGTAAGCAACGAGA -> TTATAGTAAGCAACGAGAC
CTCCAGCGGTTAGAAAGGC -> TCCAGCGGTTAGAAAGGCA
GTCCTGTTACAACCCACCT -> TCCTGTTACAACCCACCTA
CAGCACTCGCAATGAAGGG -> AGCACTCGCAATGAAGGGA
CCCCATCTATTAAGCATTC -> CCCATCTATTAAGCATTCC
GGCACATGCATACTGGACG -> GCACATGCATACTGGACGG
CTAAGTCCGAGAACCTGAG -> TAAGTCCGAGAACCTGAGT
TAATACCTGTTGTGTACTA -> AATACCTGTTGTGTACTAG
GTACTAGTGAAAAGAAGCT -> TACTAGTGAAAAGAAGCTC
TTATAGTAAGCAACGAGAC -> TATAGTAAGCAACGAGACC
CTTTTAACTGAAAGAAGTT -> TTTTAACTGAAAGAAGTTC
GATCCGAGCCACCCTCCAG -> ATCCGAGCCACCCTCCAGC
CTCGCGCACACCCCTGTTC -> TCGCGCACACCCCTGTTCA
ATCATGGGTGTGCGCCGCA -> TCATGGGTGTGCGCCGCAT
ACTCCAGGGAAGCTGTATG -> CTCCAGGGAAGCTGTATGG
CCGAAAAATTTTGAGGTCT -> CGAAAAATTTTGAGGTCTG
AAGGGAACACTCCGCCCCT -> AGGGAACACTCCGCCCCTC
GTATGGCTAATTCAGAGCT -> TATGGCTAATTCAGAGCTA
TTTATGCTAAATGCCCTCG -> TTATGCTAAATGCCCTCGC
CAGGGAACATCACAGCGTC -> AGGGAACATCACAGCGTCA
TGCTTCATAGTCTGGAAGG -> GCTTCATAGTCTGGAAGGC
TCTTACTTTCAACGGCCAC -> CTTACTTTCAACGGCCACT
CATAGCACGAGTGTGCATG -> ATAGCACGAGTGTGCATGT
TAAGGAGTAGTGGAGCTTG -> AAGGAGTAGTGGAGCTTGT
GGTGTGCGCCGCATGTTGT -> GTGTGCGCCGCATGTTGTA
GCGAGCGATGAACAGCACT -> CGAGCGATGAACAGCACTC
ATAGTAAGCAACGAGACCG -> TAGTAAGCAACGAGACCGC
CCGACGCCGCACGCTATGT -> CGACGCCGCACGCTATGTT
AGGAGTAGTGGAGCTTGTC -> GGAGTAGTGGAGCTTGTCC
ACGATTTAGAGGTCCTAAC -> CGATTTAGAGGTCCTAACC
CAGTTGCTGAAATCTTTAG -> AGTTGCTGAAATCTTTAGC
ACATCACAGCGTCATATCG -> CATCACAGCGTCATATCGG
AGAACCTACTGGTTCATGC -> GAACCTACTGGTTCATGCG
ATACCGCACACACGCGCAC -> TACCGCACACACGCGCACG
GATGCCACGTAATTTCCAT -> ATGCCACGTAATTTCCATC
GTTGCTGAAATCTTTAGCC -> TTGCTGAAATCTTTAGCCG
CAAGGGATGTAAAACTGGC -> AAGGGATGTAAAACTGGCC
GTTCGGATACAAGGGATGT -> TTCGGATACAAGGGATGTA
TAAGTCGGACTGGACGGCT -> AAGTCGGACTGGACGGCTC
TCAGGGAACATCACAGCGT -> CAGGGAACATCACAGCGTC
TAGCCGCCTACTACTCCAG -> AGCCGCCTACTACTCCAGG
CACGACGGAGGACTCAGTA -> ACGACGGAGGACTCAGTAA
CGATGAACAGCACTCGCAA -> GATGAACAGCACTCGCAAT
TATAGTAAGCAACGAGACC -> ATAGTAAGCAACGAGACCG
ACATGCATACTGGACGGCT -> CATGCATACTGGACGGCTC
AAAGACCGGACTGGCACTA -> AAGACCGGACTGGCACTAA
TTGCCATGGTCTTATGTAA -> TGCCATGGTCTTATGTAAT
TAACCAGGATGCAGACTCC -> AACCAGGATGCAGACTCCG
GTCACTTGGTACGAGTAAC -> TCACTTGGTACGAGTAACT
GCGATATATATCGCGTTAG -> CGATATATATCGCGTTAGG
CGGTTAGAAAGGCACATGC -> GGTTAGAAAGGCACATGCA
GTTGTGTACTAGTGAAAAG -> TTGTGTACTAGTGAAAAGA
ACACGCGCACGGCGTCCTG -> CACGCGCACGGCGTCCTGT
CCTAACCAGGATGCAGACT -> CTAACCAGGATGCAGACTC
GCACTATACTCGCGGCCCA -> CACTATACTCGCGGCCCAA
CCTGGAAAGGGCCCAAGCA -> CTGGAAAGGGCCCAAGCAT
AACTACAGCAATGAGGACC -> ACTACAGCAATGAGGACCA
ATGAACAGCACTCGCAATG -> TGAACAGCACTCGCAATGA
GCTAATGATCCGAGCCACC -> CTAATGATCCGAGCCACCC
CCGCACACACGCGCACGGC -> CGCACACACGCGCACGGCG
CAGCGGTTAGAAAACCGTT -> AGCGGTTAGAAAACCGTTG
CAACGTTCTAATGCATAAG -> AACGTTCTAATGCATAAGT
ACACACCCATACATAGCAC -> CACACCCATACATAGCACG
TCAGGCGAGCGATGAACAG -> CAGGCGAGCGATGAACAGC
TAGCCGACCTTACGGATTG -> AGCCGACCTTACGGATTGT
AATAAGCGAGTGCCGCAAT -> ATAAGCGAGTGCCGCAATA
AAGCTAGATCAACTGTTTA -> AGCTAGATCAACTGTTTAG
TACTCTCCTTCTGGTTATT -> ACTCTCCTTCTGGTTATTT
CACGTAATTTCCATCAGGC -> ACGTAATTTCCATCAGGCG
GGTTAGAAATTTTAAGTCG -> GTTAGAAATTTTAAGTCGG
ATTAGCGATATATATCGCG -> TTAGCGATATATATCGCGT
TAGTAGCGTAGTAGGGAGA -> AGTAGCGTAGTAGGGAGAA
AAATGCGCCTATCGGACTC -> AATGCGCCTATCGGACTCC
ATGCGCCTATCGGACTCCA -> TGCGCCTATCGGACTCCAA
AGTGAACACGTATAAACTT -> GTGAACACGTATAAACTTT
CTAGATCAACTGTTTAGCC -> TAGATCAACTGTTTAGCCG
TACTCGCGGCCCAAACCGT -> ACTCGCGGCCCAAACCGTT
CTGCACTATACTCGCGGCC -> TGCACTATACTCGCGGCCC
TGAGCAACATCCCCAGTTC -> GAGCAACATCCCCAGTTCG
AGTGCGTGGTACAATTTAA -> GTGCGTGGTACAATTTAAT
GCTTCATAGTCTGGAAGGC -> CTTCATAGTCTGGAAGGCA
TAATGGTCCGTGGCTGATC -> AATGGTCCGTGGCTGATCA
GCTTCATGTTCCGCAACAT -> CTTCATGTTCCGCAACATA
TGGACGGCTCCCGAAAACA -> GGACGGCTCCCGAAAACAC
AGAGCTAAGTCCGAGAACC -> GAGCTAAGTCCGAGAACCT
CTGTTGTGTACTAGTGAAA -> TGTTGTGTACTAGTGAAAA
GCGTCATATCGGCATGAGG -> CGTCATATCGGCATGAGGC
AACCTGAGTTCCATCTGTC -> ACCTGAGTTCCATCTGTCA
CCTATCTCAGAACTGACAG -> CTATCTCAGAACTGACAGG
AATACACACCCATACATAG -> ATACACACCCATACATAGC
GGACTCCAAATGTCCCCGT -> GACTCCAAATGTCCCCGTG
GACCACGACGGAGGACTCA -> ACCACGACGGAGGACTCAG
TAGTTTTAAGTGAAATGCG -> AGTTTTAAGTGAAATGCGC
GATACCTTGGTGGGAGAAA -> ATACCTTGGTGGGAGAAAA
TCTTAGCTCGTGTGGACCC -> CTTAGCTCGTGTGGACCCG
GAGTATATTCAGCAAGGAT -> AGTATATTCAGCAAGGATG
ATAGTCTGGAAGGCAACTA -> TAGTCTGGAAGGCAACTAG
AATTTAGTGAACACGTATA -> ATTTAGTGAACACGTATAA
CTAGGTATTCGTCAGCTTC -> TAGGTATTCGTCAGCTTCA
CCGTGGCTGATCACGAGTA -> CGTGGCTGATCACGAGTAT
CTAGTATCATGGGTGTGCG -> TAGTATCATGGGTGTGCGC
GCACGACGACGTCAAAATG -> CACGACGACGTCAAAATGG
GGTTAGAAAGGCACATGCA -> GTTAGAAAGGCACATGCAT
GTAATGGTCCGTGGCTGAT -> TAATGGTCCGTGGCTGATC
ATCCGCTTTAGTAGCGTAG -> TCCGCTTTAGTAGCGTAGT
CCAGGACCTCTTTGCTAAT -> CAGGACCTCTTTGCTAATA
GTCAACTACAGCAATGAGG -> TCAACTACAGCAATGAGGA
CAGTAATACCGCACACACG -> AGTAATACCGCACACACGC
GGGCAAGGGGATGCCACGT -> GGCAAGGGGATGCCACGTA
AGGTCCATGCAGGGCAGCT -> GGTCCATGCAGGGCAGCTT
AGGGATCCGCTTTAGTAGC -> GGGATCCGCTTTAGTAGCG
CAAGGATGCGTTGGGCAAG -> AAGGATGCGTTGGGCAAGG
CCGCAACATATGCTAAGCT -> CGCAACATATGCTAAGCTA
GAAAAAAACTGCGTAATCC -> AAAAAAACTGCGTAATCCC
GTCACGATTTAGAGGTCCT -> TCACGATTTAGAGGTCCTA
GGCTGATCACGAGTATATT -> GCTGATCACGAGTATATTC
TTATTTAGGTATCTAAGGA -> TATTTAGGTATCTAAGGAG
CTCTTTGCTAATACCTGTT -> TCTTTGCTAATACCTGTTG
ATCGGCATGAGGCTAGGAA -> TCGGCATGAGGCTAGGAAG
TCCATCAGGCGAGCGATGA -> CCATCAGGCGAGCGATGAA
CAGCGGTTAGAAACGGTGT -> AGCGGTTAGAAACGGTGTT
TTCCATCAGGCGAGCGATG -> TCCATCAGGCGAGCGATGA
TACCTGTTGTGTACTAGTG -> ACCTGTTGTGTACTAGTGA
ATATATATCGCGTTAGGTT -> TATATATCGCGTTAGGTTC
GGGCGGGGTCCTATCTCAG -> GGCGGGGTCCTATCTCAGA
CGATACAACCTTGATCAGT -> GATACAACCTTGATCAGTG
CCCCCATCTATTAAGCATT -> CCCCATCTATTAAGCATTC
CAGGCTCTGGTACGGATAC -> AGGCTCTGGTACGGATACT
TCCGAGCCACCCTCCAGCT -> CCGAGCCACCCTCCAGCTA
GAACTGACAGGCATGACCA -> AACTGACAGGCATGACCAG
ACCAATACCGATACAACCT -> CCAATACCGATACAACCTT
ACCTGAGTTCCATCTGTCA -> CCTGAGTTCCATCTGTCAC
GCGCACGGCGTCCTGTGTT -> CGCACGGCGTCCTGTGTTA
ATTAGGCCAGAGCTAAGTC -> TTAGGCCAGAGCTAAGTCC
GCATAAGTCACTTGTGATC -> CATAAGTCACTTGTGATCC
AGGCTCTGGTACGGATACT -> GGCTCTGGTACGGATACTC
TCCAGCGGTTAGAAATTTT -> CCAGCGGTTAGAAATTTTA
GAACATCACAGCGTCATAT -> AACATCACAGCGTCATATC
ACATATGCTAAGCTAATGA -> CATATGCTAAGCTAATGAT
CGTTCTAGTATCATGGGTG -> GTTCTAGTATCATGGGTGT
AGGGAACATCACAGCGTCA -> GGGAACATCACAGCGTCAT
ATACCGATACAACCTTGAT -> TACCGATACAACCTTGATC
TATAAGCGCGCGTAGTGAC -> ATAAGCGCGCGTAGTGACA
ATATAAGCGCGCGTAGTGA -> TATAAGCGCGCGTAGTGAC
GATCACGAGTATATTCAGC -> ATCACGAGTATATTCAGCA
GCTACTGGGGGATTGCCAT -> CTACTGGGGGATTGCCATG
TTCTCGCCGTGCTTTCCCA -> TCTCGCCGTGCTTTCCCAA
GGGAAGCTGTATGGCTAAT -> GGAAGCTGTATGGCTAATT
TGTGCAAATTAGCGATATA -> GTGCAAATTAGCGATATAT
AACTATAGCGATAGTGGTC -> ACTATAGCGATAGTGGTCG
AGTAGTGGAGCTTGTCCGT -> GTAGTGGAGCTTGTCCGTG
CCAGCGGCGATATAAGCGC -> CAGCGGCGATATAAGCGCG
TAATTTAGTGAACACGTAT -> AATTTAGTGAACACGTATA
AGTCTGGAAGGCAACTAGC -> GTCTGGAAGGCAACTAGCC
ATTTAGGTATCTAAGGAGT -> TTTAGGTATCTAAGGAGTA
GACTGGCACTAAATGACCT -> ACTGGCACTAAATGACCTT
AACTGACAGGCATGACCAG -> ACTGACAGGCATGACCAGG
ACCCCGACGGTAATGGTCC -> CCCCGACGGTAATGGTCCG
ATCGTCAACTACAGCAATG -> TCGTCAACTACAGCAATGA
AGAACCGCTCCTACTCAAC -> GAACCGCTCCTACTCAACT
ATCTCAGAACTGACAGGCA -> TCTCAGAACTGACAGGCAT
GGAGCTTGTCCGTGTAGTT -> GAGCTTGTCCGTGTAGTTC
CTGAAAGAAGTTCTTAGCT -> TGAAAGAAGTTCTTAGCTC
CAACATCTTAGCTTCCTCA -> AACATCTTAGCTTCCTCAC
AGGTCTGGGAGGGGAGAAC -> GGTCTGGGAGGGGAGAACC
AAGACCGGACTGGCACTAA -> AGACCGGACTGGCACTAAA
GCACACCCCTGTTCAACTA -> CACACCCCTGTTCAACTAT
ACCGCTCCTACTCAACTAA -> CCGCTCCTACTCAACTAAA
TTGTGATCCCGTTCTAGTA -> TGTGATCCCGTTCTAGTAT
TTGAGGTCTGGGAGGGGAG -> TGAGGTCTGGGAGGGGAGA
AGCCGCCTACTACTCCAGG -> GCCGCCTACTACTCCAGGG
TTGGGCAAGGGGATGCCAC -> TGGGCAAGGGGATGCCACG
CAATGAAGGGATCCGCTTT -> AATGAAGGGATCCGCTTTA
GTGCAAATTAGCGATATAT -> TGCAAATTAGCGATATATA
TTCGCAGGAGCTCTGAAGC -> TCGCAGGAGCTCTGAAGCC
CCGTGTCCTGTTACAACCC -> CGTGTCCTGTTACAACCCA
GCTCCCGAAAACTACTGTC -> CTCCCGAAAACTACTGTCA
CCTTGCTACTGGGGGATTG -> CTTGCTACTGGGGGATTGC
GTTACAACCCACCTAAGAA -> TTACAACCCACCTAAGAAG
CTCCAGGGAAGCTGTATGG -> TCCAGGGAAGCTGTATGGC
AAATGGTGGGACCCACTTG -> AATGGTGGGACCCACTTGC
CTAGCCTAGGTATTCGTCA -> TAGCCTAGGTATTCGTCAG
TGCATCCAGCGGCGATATA -> GCATCCAGCGGCGATATAA
AACTGGACGGCTCCCGAAA -> ACTGGACGGCTCCCGAAAA
GTTGGGCAAGGGGATGCCA -> TTGGGCAAGGGGATGCCAC
GATGTAAAACTGGCCGATA -> ATGTAAAACTGGCCGATAC
ACGACGGAGGACTCAGTAA -> CGACGGAGGACTCAGTAAT
TGTAATGCCACACGGGCTT -> GTAATGCCACACGGGCTTT
CAGCTTCATTATTGGTTCA -> AGCTTCATTATTGGTTCAA
GAACCGCTCCTACTCAACT -> AACCGCTCCTACTCAACTA
AACTTTTATGCTAAATGCC -> ACTTTTATGCTAAATGCCC
CTTAGCTCGTGTGGACCCG -> TTAGCTCGTGTGGACCCGA
TAATGATCCGAGCCACCCT -> AATGATCCGAGCCACCCTC
TCATGCGATATTTTCGCGT -> CATGCGATATTTTCGCGTT
GGCTAGGAAGAACCGCTCC -> GCTAGGAAGAACCGCTCCT
ACACGGGCTTTTAACTGAA -> CACGGGCTTTTAACTGAAA
TAAATGACCTTTCGCCGTG -> AAATGACCTTTCGCCGTGC
TAGGTATTCGTCAGCTTCA -> AGGTATTCGTCAGCTTCAT
AGTTCCATCTGTCACGATT -> GTTCCATCTGTCACGATTT
CGACGACGTCAAAATGGTG -> GACGACGTCAAAATGGTGG
AAGCTAATGATCCGAGCCA -> AGCTAATGATCCGAGCCAC
CTACAGTTACCCGCAACTA -> TACAGTTACCCGCAACTAC
TGAGGACCAAGAACCGTGC -> GAGGACCAAGAACCGTGCG
GACGACGTCAAAATGGTGG -> ACGACGTCAAAATGGTGGG
TTTCGCCGTGCTTCATAGT -> TTCGCCGTGCTTCATAGTC
TCTGGTTATTTAGGTATCT -> CTGGTTATTTAGGTATCTA
GATACAAGGGATGTAAAAC -> ATACAAGGGATGTAAAACT
TTTTAAGTCGGACTGGACG -> TTTAAGTCGGACTGGACGG
CAGTTCGGATACAAGGGAT -> AGTTCGGATACAAGGGATG
CAGTTACCCGCAACTACGA -> AGTTACCCGCAACTACGAC
TACTGGTTCATGCGATATT -> ACTGGTTCATGCGATATTT
TGCACTAGCCAGTGAGCTA -> GCACTAGCCAGTGAGCTAC
TATCGGACTCCAAATGTCC -> ATCGGACTCCAAATGTCCC
CGACCCTCATCAAGTGCGT -> GACCCTCATCAAGTGCGTG
AAATTTTAAGTCGGACTGG -> AATTTTAAGTCGGACTGGA
GGCCGATACCTTGGTGGGA -> GCCGATACCTTGGTGGGAG
TATCGGCATGAGGCTAGGA -> ATCGGCATGAGGCTAGGAA
TTTCCCCAGGACCTCTTTG -> TTCCCCAGGACCTCTTTGC
GGTGTTTTCAACTGGACGG -> GTGTTTTCAACTGGACGGC
TGTGCATGTTGTTGACTCG -> GTGCATGTTGTTGACTCGT
TCGCGTTAGGTTCAGTAGA -> CGCGTTAGGTTCAGTAGAG
TGTCCTGTTACAACCCACC -> GTCCTGTTACAACCCACCT
GACCAAGAACCGTGCGACC -> ACCAAGAACCGTGCGACCC
GACCCGGCTTCATGTTCCG -> ACCCGGCTTCATGTTCCGC
CCCGACCACGACGGAGGAC -> CCGACCACGACGGAGGACT
AGGCTAGGAAGAACCGCTC -> GGCTAGGAAGAACCGCTCC
AGACCGGACTGGCACTAAA -> GACCGGACTGGCACTAAAT
ATGGGTGTGCGCCGCATGT -> TGGGTGTGCGCCGCATGTT
TTACGGATTGTGAGACCAC -> TACGGATTGTGAGACCACC
TCAACGGCCACTGCACTAG -> CAACGGCCACTGCACTAGC
GACCTCCAGCGGTTAGAAA -> ACCTCCAGCGGTTAGAAAG
GACTGGGGCGGGGTCCTAT -> ACTGGGGCGGGGTCCTATC
ACCCGACCACGACGGAGGA -> CCCGACCACGACGGAGGAC
GTACAATTTAATTTAGTGA -> TACAATTTAATTTAGTGAA
AGACCGCGCATCTTACTTT -> GACCGCGCATCTTACTTTC
GTCACTTGTGATCCCGTTC -> TCACTTGTGATCCCGTTCT
AGCCGACCTTACGGATTGT -> GCCGACCTTACGGATTGTG
AAATCACTGCACTATACTC -> AATCACTGCACTATACTCG
GGACCAAGAACCGTGCGAC -> GACCAAGAACCGTGCGACC
ATCCGAGCCACCCTCCAGC -> TCCGAGCCACCCTCCAGCT
GCCACACGGGCTTTTAACT -> CCACACGGGCTTTTAACTG
GTGCGTGGTACAATTTAAT -> TGCGTGGTACAATTTAATT
CCTTGGTGGGAGAAAAGGG -> CTTGGTGGGAGAAAAGGGA
CCGAGCCACCCTCCAGCTA -> CGAGCCACCCTCCAGCTAC
AGACTGGGGCGGGGTCCTA -> GACTGGGGCGGGGTCCTAT
ATCCCGTGTCCTGTTACAA -> TCCCGTGTCCTGTTACAAC
TCTTAGCTTCCTCACCTAA -> CTTAGCTTCCTCACCTAAT
AGCTTCCTCACCTAATGAG -> GCTTCCTCACCTAATGAGC
ATGTTCGCAGGAGCTCTGA -> TGTTCGCAGGAGCTCTGAA
GTTCTTAGCTCGTGTGGAC -> TTCTTAGCTCGTGTGGACC
AGAGGTCCTAACCAGGATG -> GAGGTCCTAACCAGGATGC
TCAACTACAGCAATGAGGA -> CAACTACAGCAATGAGGAC
CTACAGCAATGAGGACCAA -> TACAGCAATGAGGACCAAG
AGCGATATATATCGCGTTA -> GCGATATATATCGCGTTAG
ATCGGACTCCAAATGTCCC -> TCGGACTCCAAATGTCCCC
CCAGCGGTTAGAAAACCGT -> CAGCGGTTAGAAAACCGTT
GTTAGAAATTTTAAGTCGG -> TTAGAAATTTTAAGTCGGA
CGTGGCTGATCACGAGTAT -> GTGGCTGATCACGAGTATA
CTAGTTTTAAGTGAAATGC -> TAGTTTTAAGTGAAATGCG
TTCTGGTTATTTAGGTATC -> TCTGGTTATTTAGGTATCT
GTAGTTCCCCCATCTATTA -> TAGTTCCCCCATCTATTAA
CTACCTCCAGCGGTTAGAA -> TACCTCCAGCGGTTAGAAA
CACTCGCAATGAAGGGATC -> ACTCGCAATGAAGGGATCC
CACGACGACGTCAAAATGG -> ACGACGACGTCAAAATGGT
GATACAACCTTGATCAGTG -> ATACAACCTTGATCAGTGA
ATCACAGCGTCATATCGGC -> TCACAGCGTCATATCGGCA
CTCCAAATGTCCCCGTGGC -> TCCAAATGTCCCCGTGGCA
CGCAATGAAGGGATCCGCT -> GCAATGAAGGGATCCGCTT
AATTTAATTTAGTGAACAC -> ATTTAATTTAGTGAACACG
CGACGGAGGACTCAGTAAT -> GACGGAGGACTCAGTAATA
TGAGAAAAAAACTGCGTAA -> GAGAAAAAAACTGCGTAAT
GGGAAAATCGACTAAATCA -> GGAAAATCGACTAAATCAC
GCGCCTATCGGACTCCAAA -> CGCCTATCGGACTCCAAAT
TGCTGAAATCTTTAGCCGA -> GCTGAAATCTTTAGCCGAC
GACCGCGCATCTTACTTTC -> ACCGCGCATCTTACTTTCA
CCGCAACTACGACCCGGCT -> CGCAACTACGACCCGGCTT
CCCAAACCGTTGAGAACAC -> CCAAACCGTTGAGAACACG
TTGTCCGTGTAGTTCCTTG -> TGTCCGTGTAGTTCCTTGC
GGACCTCTTTGCTAATACC -> GACCTCTTTGCTAATACCT
CAGAACTAGGTTTCGACCG -> AGAACTAGGTTTCGACCGG
TATATCGCGTTAGGTTCAG -> ATATCGCGTTAGGTTCAGT
CACTGCACTATACTCGCGG -> ACTGCACTATACTCGCGGC
GGCCAGAGCTAAGTCCGAG -> GCCAGAGCTAAGTCCGAGA
TAGATCAACTGTTTAGCCG -> AGATCAACTGTTTAGCCGC
CGGCCACTGCACTAGCCAG -> GGCCACTGCACTAGCCAGT
GAACCTACTGGTTCATGCG -> AACCTACTGGTTCATGCGA
CGTTGGGTGACTGGACGGC -> GTTGGGTGACTGGACGGCT
AGTGACACGCAAGCATTAG -> GTGACACGCAAGCATTAGG
GTCCGTGGCTGATCACGAG -> TCCGTGGCTGATCACGAGT
GTCAGGGAACATCACAGCG -> TCAGGGAACATCACAGCGT
GGCCCAAACCGTTGAGAAC -> GCCCAAACCGTTGAGAACA
AGAAGCTCCAGACCTGGAA -> GAAGCTCCAGACCTGGAAA
AGGACCTCTTTGCTAATAC -> GGACCTCTTTGCTAATACC
GTGCGCCGCATGTTGTAGT -> TGCGCCGCATGTTGTAGTT
CGTTCAGACTGGGGCGGGG -> GTTCAGACTGGGGCGGGGT
ACCAGGCTCTGGTACGGAT -> CCAGGCTCTGGTACGGATA
GTTATCGTCAACTACAGCA -> TTATCGTCAACTACAGCAA
CAAGTGCGTGGTACAATTT -> AAGTGCGTGGTACAATTTA
CTTCATGTTCCGCAACATA -> TTCATGTTCCGCAACATAT
TGGGACCCACTTGCATCCA -> GGGACCCACTTGCATCCAG
GTGAAAAGAAGCTCCAGAC -> TGAAAAGAAGCTCCAGACC
GTTAGAAAACCGTTGGGTG -> TTAGAAAACCGTTGGGTGA
TGAGTTCCATCTGTCACGA -> GAGTTCCATCTGTCACGAT
TAGAAACGGTGTTTTCAAC -> AGAAACGGTGTTTTCAACT
CAACCGACGCCGCACGCTA -> AACCGACGCCGCACGCTAT
ATCTAAGGAGTAGTGGAGC -> TCTAAGGAGTAGTGGAGCT
GAAACGGTGTTTTCAACTG -> AAACGGTGTTTTCAACTGG
GCGATAGTGGTCGCTACAG -> CGATAGTGGTCGCTACAGT
CCACTTGCATCCAGCGGCG -> CACTTGCATCCAGCGGCGA
ACATTATAGTAAGCAACGA -> CATTATAGTAAGCAACGAG
GGACGGCTCCCGAAAAATT -> GACGGCTCCCGAAAAATTT
TCAACCGACGCCGCACGCT -> CAACCGACGCCGCACGCTA
GTGTGGACCCGACCACGAC -> TGTGGACCCGACCACGACG
GTTCGCAGGAGCTCTGAAG -> TTCGCAGGAGCTCTGAAGC
AATTCAGAGCTAGTTTTAA -> ATTCAGAGCTAGTTTTAAG
CAACTAAAATTCTCGCCGT -> AACTAAAATTCTCGCCGTG
AATTTCCATCAGGCGAGCG -> ATTTCCATCAGGCGAGCGA
CCCATACATAGCACGAGTG -> CCATACATAGCACGAGTGT
ATGCAGACTCCGTCAACCG -> TGCAGACTCCGTCAACCGA
AATGAGAAAAAAACTGCGT -> ATGAGAAAAAAACTGCGTA
AGCATTAGGCCAGAGCTAA -> GCATTAGGCCAGAGCTAAG
ATATATCGCGTTAGGTTCA -> TATATCGCGTTAGGTTCAG
AGTGAAAAGAAGCTCCAGA -> GTGAAAAGAAGCTCCAGAC
GTCCTAACCAGGATGCAGA -> TCCTAACCAGGATGCAGAC
CTCCCGAAAATACACACCC -> TCCCGAAAATACACACCCA
CACCCTCCAGCTACCTCCA -> ACCCTCCAGCTACCTCCAG
CGCCTATCGGACTCCAAAT -> GCCTATCGGACTCCAAATG
TCCATCTGTCACGATTTAG -> CCATCTGTCACGATTTAGA
AGAAATTTTAAGTCGGACT -> GAAATTTTAAGTCGGACTG
CTCCCGAAAAATTTTGAGG -> TCCCGAAAAATTTTGAGGT
CTACGACCCGGCTTCATGT -> TACGACCCGGCTTCATGTT
ACCCACTTGCATCCAGCGG -> CCCACTTGCATCCAGCGGC
GAAGCCCGCCATGAGACTG -> AAGCCCGCCATGAGACTGG
CTCATCAAGTGCGTGGTAC -> TCATCAAGTGCGTGGTACA
AAGTCACTTGTGATCCCGT -> AGTCACTTGTGATCCCGTT
CGATATATATCGCGTTAGG -> GATATATATCGCGTTAGGT
TTTTATGCTAAATGCCCTC -> TTTATGCTAAATGCCCTCG
TATGCTAAATGCCCTCGCG -> ATGCTAAATGCCCTCGCGC
GATGCAGACTCCGTCAACC -> ATGCAGACTCCGTCAACCG
AGAGCGGAAAAGAATGAGA -> GAGCGGAAAAGAATGAGAA
CCTTCTGGTTATTTAGGTA -> CTTCTGGTTATTTAGGTAT
AGGTTTCGACCGGGGGGCA -> GGTTTCGACCGGGGGGCAT
ACCCACCTAAGAAGTATGC -> CCCACCTAAGAAGTATGCC
TGTTGACTCGTTCAGACTG -> GTTGACTCGTTCAGACTGG
CCTTTCGCCGTGCTTCATA -> CTTTCGCCGTGCTTCATAG
AAAACTACTGTCAGGGAAC -> AAACTACTGTCAGGGAACA
TTAGTAGCGTAGTAGGGAG -> TAGTAGCGTAGTAGGGAGA
TGGTTCATGCGATATTTTC -> GGTTCATGCGATATTTTCG
CCAAGCATTAGACCCCGAC -> CAAGCATTAGACCCCGACG
ACAACGTTCTAATGCATAA -> CAACGTTCTAATGCATAAG
GGAACACTCCGCCCCTCTT -> GAACACTCCGCCCCTCTTT
ATGTCCCTTCACCCACATT -> TGTCCCTTCACCCACATTA
TCTTGGATCACAACGTTCT -> CTTGGATCACAACGTTCTA
CAACGGCCACTGCACTAGC -> AACGGCCACTGCACTAGCC
AAAGGGCCCAAGCATTAGA -> AAGGGCCCAAGCATTAGAC
CTTTTATGCTAAATGCCCT -> TTTTATGCTAAATGCCCTC
AGCTACCTCCAGCGGTTAG -> GCTACCTCCAGCGGTTAGA
CCATCTATTAAGCATTCCA -> CATCTATTAAGCATTCCAT
CTCGCAATGAAGGGATCCG -> TCGCAATGAAGGGATCCGC
CTGACAGGCATGACCAGGC -> TGACAGGCATGACCAGGCT
GCAACATATGCTAAGCTAA -> CAACATATGCTAAGCTAAT
AAACGGTGTTTTCAACTGG -> AACGGTGTTTTCAACTGGA
CCGTCAACCGACGCCGCAC -> CGTCAACCGACGCCGCACG
AGGAAAGACCGGACTGGCA -> GGAAAGACCGGACTGGCAC
ATCAGGCGAGCGATGAACA -> TCAGGCGAGCGATGAACAG
AAACTACTGTCAGGGAACA -> AACTACTGTCAGGGAACAT
GCAGACTCCGTCAACCGAC -> CAGACTCCGTCAACCGACG
CTGAAATCTTTAGCCGACC -> TGAAATCTTTAGCCGACCT
GGGATGTAAAACTGGCCGA -> GGATGTAAAACTGGCCGAT
CATCCAGCGGCGATATAAG -> ATCCAGCGGCGATATAAGC
CCCCAGGACCTCTTTGCTA -> CCCAGGACCTCTTTGCTAA
TTGTGAGACCACCTCCAGC -> TGTGAGACCACCTCCAGCG
GCTAATACCTGTTGTGTAC -> CTAATACCTGTTGTGTACT
GGTACGAGTAACTTTCCTT -> GTACGAGTAACTTTCCTTG
CACTCCGCCCCTCTTTTCC -> ACTCCGCCCCTCTTTTCCC
GTGTAGTTCCTTGCTACTG -> TGTAGTTCCTTGCTACTGG
CCCGTGTCCTGTTACAACC -> CCGTGTCCTGTTACAACCC
CCCAGTTCGGATACAAGGG -> CCAGTTCGGATACAAGGGA
ATGGTCTTATGTAATGCCA -> TGGTCTTATGTAATGCCAC
TTTCGACCGGGGGGCATCT -> TTCGACCGGGGGGCATCTA
TAGCCTAGGTATTCGTCAG -> AGCCTAGGTATTCGTCAGC
CAATATGTGTAGGTCTTGG -> AATATGTGTAGGTCTTGGA
CGTTGAGAACACGAGGAAA -> GTTGAGAACACGAGGAAAG
CATTAGGCCAGAGCTAAGT -> ATTAGGCCAGAGCTAAGTC
TTTTCGCGTTGTCACTTGG -> TTTCGCGTTGTCACTTGGT
GGGAGAACCTACTGGTTCA -> GGAGAACCTACTGGTTCAT
CACTTGTGATCCCGTTCTA -> ACTTGTGATCCCGTTCTAG
TTGTTGACTCGTTCAGACT -> TGTTGACTCGTTCAGACTG
AGTAATACCGCACACACGC -> GTAATACCGCACACACGCG
GAACCGTGCGACCCTCATC -> AACCGTGCGACCCTCATCA
CCTACTACTCCAGGGAAGC -> CTACTACTCCAGGGAAGCT
GATTTAGAGGTCCTAACCA -> ATTTAGAGGTCCTAACCAG
ACTGTCAGGGAACATCACA -> CTGTCAGGGAACATCACAG
ATAGTGGTCGCTACAGTTA -> TAGTGGTCGCTACAGTTAC
TCCATGCAGGGCAGCTTCC -> CCATGCAGGGCAGCTTCCT
CTACTACTCCAGGGAAGCT -> TACTACTCCAGGGAAGCTG
TGCGTTGGGCAAGGGGATG -> GCGTTGGGCAAGGGGATGC
ACGAAGGTCCATGCAGGGC -> CGAAGGTCCATGCAGGGCA
GCACGCTATGTTCGCAGGA -> CACGCTATGTTCGCAGGAG
TTCAGACTGGGGCGGGGTC -> TCAGACTGGGGCGGGGTCC
GGTTAGAAACGGTGTTTTC -> GTTAGAAACGGTGTTTTCA
GTAGTGACACGCAAGCATT -> TAGTGACACGCAAGCATTA
TAGTAGGGAGAACGAAGGT -> AGTAGGGAGAACGAAGGTC
AGGGGAGAACCTACTGGTT -> GGGGAGAACCTACTGGTTC
AAGCCCGCCATGAGACTGG -> AGCCCGCCATGAGACTGGT
GTAAGCAACGAGACCGCGC -> TAAGCAACGAGACCGCGCA
GCACATGCATACTGGACGG -> CACATGCATACTGGACGGC
TTCAGTAGAGCGGAAAAGA -> TCAGTAGAGCGGAAAAGAA
ATCACTGCACTATACTCGC -> TCACTGCACTATACTCGCG
GAAAGACCGGACTGGCACT -> AAAGACCGGACTGGCACTA
ACCGTGCGACCCTCATCAA -> CCGTGCGACCCTCATCAAG
TAAGTCACTTGTGATCCCG -> AAGTCACTTGTGATCCCGT
GGGAGGGGAGAACCTACTG -> GGAGGGGAGAACCTACTGG
AGCGTCATATCGGCATGAG -> GCGTCATATCGGCATGAGG
AGGATGCAGACTCCGTCAA -> GGATGCAGACTCCGTCAAC
ACCTAATGAGCAACATCCC -> CCTAATGAGCAACATCCCC
GTCTTGGATCACAACGTTC -> TCTTGGATCACAACGTTCT
TTGCATCCAGCGGCGATAT -> TGCATCCAGCGGCGATATA
GGAGGGGAGAACCTACTGG -> GAGGGGAGAACCTACTGGT
CATTCCATCTGAACATCGG -> ATTCCATCTGAACATCGGG
ACCGCGCATCTTACTTTCA -> CCGCGCATCTTACTTTCAA
TGGAAGGCAACTAGCCTAG -> GGAAGGCAACTAGCCTAGG
AAGGCAACTAGCCTAGGTA -> AGGCAACTAGCCTAGGTAT
GGGGCATCTAGTTGGGAAA -> GGGCATCTAGTTGGGAAAA
CTCGTGTGGACCCGACCAC -> TCGTGTGGACCCGACCACG
TCCAGCGGCGATATAAGCG -> CCAGCGGCGATATAAGCGC
TAAAACTGGCCGATACCTT -> AAAACTGGCCGATACCTTG
CATATGCTAAGCTAATGAT -> ATATGCTAAGCTAATGATC
CGTCAACTACAGCAATGAG -> GTCAACTACAGCAATGAGG
GAACTAGGTTTCGACCGGG -> AACTAGGTTTCGACCGGGG
CAGACTGGGGCGGGGTCCT -> AGACTGGGGCGGGGTCCTA
AGAAGTATGCCTTAGACCT -> GAAGTATGCCTTAGACCTC
TCAGACTGGGGCGGGGTCC -> CAGACTGGGGCGGGGTCCT
AAGGCACATGCATACTGGA -> AGGCACATGCATACTGGAC
GGGTCCTATCTCAGAACTG -> GGTCCTATCTCAGAACTGA
GTGAGGGGTCAGAACTAGG -> TGAGGGGTCAGAACTAGGT
TTTGCTAATACCTGTTGTG -> TTGCTAATACCTGTTGTGT
AGGGGATGCCACGTAATTT -> GGGGATGCCACGTAATTTC
CCGAGAACCTGAGTTCCAT -> CGAGAACCTGAGTTCCATC
GGGTCAGAACTAGGTTTCG -> GGTCAGAACTAGGTTTCGA
AAACCGTTGAGAACACGAG -> AACCGTTGAGAACACGAGG
CCCACCTAAGAAGTATGCC -> CCACCTAAGAAGTATGCCT
GCCGCCTACTACTCCAGGG -> CCGCCTACTACTCCAGGGA
ACAACCCACCTAAGAAGTA -> CAACCCACCTAAGAAGTAT
AGTTCTTAGCTCGTGTGGA -> GTTCTTAGCTCGTGTGGAC
TCCAGACCTGGAAAGGGCC -> CCAGACCTGGAAAGGGCCC
ATTTTAAGTCGGACTGGAC -> TTTTAAGTCGGACTGGACG
TTAAGTGAAATGCGCCTAT -> TAAGTGAAATGCGCCTATC
GACGTCAAAATGGTGGGAC -> ACGTCAAAATGGTGGGACC
GCCTACTACTCCAGGGAAG -> CCTACTACTCCAGGGAAGC
CCGTGCTTTCCCAAGCTAG -> CGTGCTTTCCCAAGCTAGA
ATGACCAGGCTCTGGTACG -> TGACCAGGCTCTGGTACGG
CCCTCATCAAGTGCGTGGT -> CCTCATCAAGTGCGTGGTA
ACCTTGGTGGGAGAAAAGG -> CCTTGGTGGGAGAAAAGGG
CAAGCTAGATCAACTGTTT -> AAGCTAGATCAACTGTTTA
CTACTGGGGGATTGCCATG -> TACTGGGGGATTGCCATGG
CTATGTTCGCAGGAGCTCT -> TATGTTCGCAGGAGCTCTG
AACACGTATAAACTTTTAT -> ACACGTATAAACTTTTATG
CCTCCAGCGGTTAGAAAGG -> CTCCAGCGGTTAGAAAGGC
ATATCGCGTTAGGTTCAGT -> TATCGCGTTAGGTTCAGTA
CCATCTGAACATCGGGCGT -> CATCTGAACATCGGGCGTA
TTAGCCGCCTACTACTCCA -> TAGCCGCCTACTACTCCAG
CGATATAAGCGCGCGTAGT -> GATATAAGCGCGCGTAGTG
TCTGGTACGGATACTCTGG -> CTGGTACGGATACTCTGGA
TGCCACACGGGCTTTTAAC -> GCCACACGGGCTTTTAACT
TACGAGTAACTTTCCTTGC -> ACGAGTAACTTTCCTTGCC
CGTCCTGTGTTATCGTCAA -> GTCCTGTGTTATCGTCAAC
TTCCTTTTAACCTCCAGCG -> TCCTTTTAACCTCCAGCGG
CTCAGAACTGACAGGCATG -> TCAGAACTGACAGGCATGA
GCGCCGCATGTTGTAGTTC -> CGCCGCATGTTGTAGTTCC
GCTAGTTTTAAGTGAAATG -> CTAGTTTTAAGTGAAATGC
GCTTCCTCACCTAATGAGC -> CTTCCTCACCTAATGAGCA
ACTGAAAGAAGTTCTTAGC -> CTGAAAGAAGTTCTTAGCT
CGAAGGTCCATGCAGGGCA -> GAAGGTCCATGCAGGGCAG
CCACCTAAGAAGTATGCCT -> CACCTAAGAAGTATGCCTT
TGCGATATTTTCGCGTTGT -> GCGATATTTTCGCGTTGTC
GCAGCTTCCTTTTAACCTC -> CAGCTTCCTTTTAACCTCC
CCATCTGTCACGATTTAGA -> CATCTGTCACGATTTAGAG
AGAACTAGGTTTCGACCGG -> GAACTAGGTTTCGACCGGG
GGTACAATTTAATTTAGTG -> GTACAATTTAATTTAGTGA
CGCCGCATGTTGTAGTTCC -> GCCGCATGTTGTAGTTCCC
CGAGCGATGAACAGCACTC -> GAGCGATGAACAGCACTCG
TGCCATGGTCTTATGTAAT -> GCCATGGTCTTATGTAATG
CAACTGTTTAGCCGCCTAC -> AACTGTTTAGCCGCCTACT
CCAGACCTGGAAAGGGCCC -> CAGACCTGGAAAGGGCCCA
ACTCAACTAAAATTCTCGC -> CTCAACTAAAATTCTCGCC
TAAACTTTTATGCTAAATG -> AAACTTTTATGCTAAATGC
CATGCATACTGGACGGCTC -> ATGCATACTGGACGGCTCC
GTGGCACGACGACGTCAAA -> TGGCACGACGACGTCAAAA
GTAATACCGCACACACGCG -> TAATACCGCACACACGCGC
ACATCGGGCGTACTCTCCT -> CATCGGGCGTACTCTCCTT
CTGGTACGGATACTCTGGA -> TGGTACGGATACTCTGGAA
GCAATATGTGTAGGTCTTG -> CAATATGTGTAGGTCTTGG
TACAGCAATGAGGACCAAG -> ACAGCAATGAGGACCAAGA
TAGCCAGTGAGCTACCAGT -> AGCCAGTGAGCTACCAGTG
TACCAGTGGATCACTAGGG -> ACCAGTGGATCACTAGGGT
ACCGGACTGGCACTAAATG -> CCGGACTGGCACTAAATGA
ACTGCACTATACTCGCGGC -> CTGCACTATACTCGCGGCC
TAGTTGGGAAAATCGACTA -> AGTTGGGAAAATCGACTAA
GACTCCAAATGTCCCCGTG -> ACTCCAAATGTCCCCGTGG
GGATGCGTTGGGCAAGGGG -> GATGCGTTGGGCAAGGGGA
CCCGTTCTAGTATCATGGG -> CCGTTCTAGTATCATGGGT
GACCTTACGGATTGTGAGA -> ACCTTACGGATTGTGAGAC
CCATCAGGCGAGCGATGAA -> CATCAGGCGAGCGATGAAC
GAGTAACTTTCCTTGCCCC -> AGTAACTTTCCTTGCCCCA
GAGTGCCGCAATATGTGTA -> AGTGCCGCAATATGTGTAG
AATCGACTAAATCACTGCA -> ATCGACTAAATCACTGCAC
TCAATGTCCCTTCACCCAC -> CAATGTCCCTTCACCCACA
CCGTGTAGTTCCTTGCTAC -> CGTGTAGTTCCTTGCTACT
AAGAACCGCTCCTACTCAA -> AGAACCGCTCCTACTCAAC
CTTGTGATCCCGTTCTAGT -> TTGTGATCCCGTTCTAGTA
TTGATCAGTGAGGGGTCAG -> TGATCAGTGAGGGGTCAGA
GCGGTTAGAAAACCGTTGG -> CGGTTAGAAAACCGTTGGG
GTTTAGCCGCCTACTACTC -> TTTAGCCGCCTACTACTCC
TCATTATTGGTTCAATGTC -> CATTATTGGTTCAATGTCC
TAAGTCCGAGAACCTGAGT -> AAGTCCGAGAACCTGAGTT
CCCACATTATAGTAAGCAA -> CCACATTATAGTAAGCAAC
TGGTACGAGTAACTTTCCT -> GGTACGAGTAACTTTCCTT
AAACACCAATACCGATACA -> AACACCAATACCGATACAA
TTGGGAAAATCGACTAAAT -> TGGGAAAATCGACTAAATC
GCTAGGAAGAACCGCTCCT -> CTAGGAAGAACCGCTCCTA
CATATCGGCATGAGGCTAG -> ATATCGGCATGAGGCTAGG
CTCTGAAGCCCGCCATGAG -> TCTGAAGCCCGCCATGAGA
AAACTTTTATGCTAAATGC -> AACTTTTATGCTAAATGCC
TGGGCAAGGGGATGCCACG -> GGGCAAGGGGATGCCACGT
GAGAAAAGGGAACACTCCG -> AGAAAAGGGAACACTCCGC
CCGTTGAGAACACGAGGAA -> CGTTGAGAACACGAGGAAA
AGGGAACACTCCGCCCCTC -> GGGAACACTCCGCCCCTCT
TGGGAGAAAAGGGAACACT -> GGGAGAAAAGGGAACACTC
AGTTGGGAAAATCGACTAA -> GTTGGGAAAATCGACTAAA
GCAAGGATGCGTTGGGCAA -> CAAGGATGCGTTGGGCAAG
GCACTCGCAATGAAGGGAT -> CACTCGCAATGAAGGGATC
CGAGTGCCGCAATATGTGT -> GAGTGCCGCAATATGTGTA
GCATGTTGTAGTTCCCCCA -> CATGTTGTAGTTCCCCCAT
AGTGTGCATGTTGTTGACT -> GTGTGCATGTTGTTGACTC
CGCACACACGCGCACGGCG -> GCACACACGCGCACGGCGT
ATGCCTTAGACCTCCAGCG -> TGCCTTAGACCTCCAGCGG
TCGGGCGTACTCTCCTTCT -> CGGGCGTACTCTCCTTCTG
TGAGACCACCTCCAGCGGT -> GAGACCACCTCCAGCGGTT
GTGGACCCGACCACGACGG -> TGGACCCGACCACGACGGA
CAGGGAAGCTGTATGGCTA -> AGGGAAGCTGTATGGCTAA
CAACCTTGATCAGTGAGGG -> AACCTTGATCAGTGAGGGG
TGAGACTGGTTATGGGGCC -> GAGACTGGTTATGGGGCCA
GAGCTCTGAAGCCCGCCAT -> AGCTCTGAAGCCCGCCATG
AACCTCCAGCGGTTAGAAA -> ACCTCCAGCGGTTAGAAAA
CACAACGTTCTAATGCATA -> ACAACGTTCTAATGCATAA
CAGGCGAGCGATGAACAGC -> AGGCGAGCGATGAACAGCA
GGCAACTAGCCTAGGTATT -> GCAACTAGCCTAGGTATTC
CTCCCGAAAACACCAATAC -> TCCCGAAAACACCAATACC
AATCTTTAGCCGACCTTAC -> ATCTTTAGCCGACCTTACG
CGAGTGTGCATGTTGTTGA -> GAGTGTGCATGTTGTTGAC
CTGGGGCGGGGTCCTATCT -> TGGGGCGGGGTCCTATCTC
TAGGAAGAACCGCTCCTAC -> AGGAAGAACCGCTCCTACT
GTGACTGGACGGCTCCCGA -> TGACTGGACGGCTCCCGAA
GATGAACAGCACTCGCAAT -> ATGAACAGCACTCGCAATG
CCTAATGAGCAACATCCCC -> CTAATGAGCAACATCCCCA
GGAAAGACCGGACTGGCAC -> GAAAGACCGGACTGGCACT
GCGTAGTGACACGCAAGCA -> CGTAGTGACACGCAAGCAT
GGCCCAAGCATTAGACCCC -> GCCCAAGCATTAGACCCCG
ATTTTGAGGTCTGGGAGGG -> TTTTGAGGTCTGGGAGGGG
GCCATGGTCTTATGTAATG -> CCATGGTCTTATGTAATGC
TGGACGGCTCCCGAAAATA -> GGACGGCTCCCGAAAATAC
CCAGAGCTAAGTCCGAGAA -> CAGAGCTAAGTCCGAGAAC
GGATCACAACGTTCTAATG -> GATCACAACGTTCTAATGC
AACCGTGCGACCCTCATCA -> ACCGTGCGACCCTCATCAA
GTTCAGTAGAGCGGAAAAG -> TTCAGTAGAGCGGAAAAGA
CCGACCACGACGGAGGACT -> CGACCACGACGGAGGACTC
TCCTGTGTTATCGTCAACT -> CCTGTGTTATCGTCAACTA
ATTCTCGCCGTGCTTTCCC -> TTCTCGCCGTGCTTTCCCA
GGCGTCCTGTGTTATCGTC -> GCGTCCTGTGTTATCGTCA
GTTCCTTGCTACTGGGGGA -> TTCCTTGCTACTGGGGGAT
TAGTGGTCGCTACAGTTAC -> AGTGGTCGCTACAGTTACC
GCGTACTCTCCTTCTGGTT -> CGTACTCTCCTTCTGGTTA
TAATGCATAAGTCACTTGT -> AATGCATAAGTCACTTGTG
TGACAGGCATGACCAGGCT -> GACAGGCATGACCAGGCTC
CCAGGATGCAGACTCCGTC -> CAGGATGCAGACTCCGTCA
GGCTCCCGAAAATACACAC -> GCTCCCGAAAATACACACC
GGGTGACTGGACGGCTCCC -> GGTGACTGGACGGCTCCCG
CGCACGCTATGTTCGCAGG -> GCACGCTATGTTCGCAGGA
TAGACCTCCAGCGGTTAGA -> AGACCTCCAGCGGTTAGAA
GCAAGCATTAGGCCAGAGC -> CAAGCATTAGGCCAGAGCT
AAGAAGTTCTTAGCTCGTG -> AGAAGTTCTTAGCTCGTGT
GTATATTCAGCAAGGATGC -> TATATTCAGCAAGGATGCG
CGAAAACTACTGTCAGGGA -> GAAAACTACTGTCAGGGAA
GGAGGACTCAGTAATACCG -> GAGGACTCAGTAATACCGC
GCACACACGCGCACGGCGT -> CACACACGCGCACGGCGTC
AGTCCGAGAACCTGAGTTC -> GTCCGAGAACCTGAGTTCC
AGCAACGAGACCGCGCATC -> GCAACGAGACCGCGCATCT
AGGACCAAGAACCGTGCGA -> GGACCAAGAACCGTGCGAC
CTGAACATCGGGCGTACTC -> TGAACATCGGGCGTACTCT
CCGTGGCACGACGACGTCA -> CGTGGCACGACGACGTCAA
AGGCCAGAGCTAAGTCCGA -> GGCCAGAGCTAAGTCCGAG
TAGTGACACGCAAGCATTA -> AGTGACACGCAAGCATTAG
ACCCTCATCAAGTGCGTGG -> CCCTCATCAAGTGCGTGGT
GAAAACCGTTGGGTGACTG -> AAAACCGTTGGGTGACTGG
TGAGGGGTCAGAACTAGGT -> GAGGGGTCAGAACTAGGTT
ACCCGCAACTACGACCCGG -> CCCGCAACTACGACCCGGC
GCTGATCACGAGTATATTC -> CTGATCACGAGTATATTCA
GTATGCCTTAGACCTCCAG -> TATGCCTTAGACCTCCAGC
GAGCCACCCTCCAGCTACC -> AGCCACCCTCCAGCTACCT
TATGGCTAATTCAGAGCTA -> ATGGCTAATTCAGAGCTAG
AACACTCCGCCCCTCTTTT -> ACACTCCGCCCCTCTTTTC
AGCTAATGATCCGAGCCAC -> GCTAATGATCCGAGCCACC
GTTGTCACTTGGTACGAGT -> TTGTCACTTGGTACGAGTA
TCCGCCCCTCTTTTCCCCA -> CCGCCCCTCTTTTCCCCAG
GTACGAGTAACTTTCCTTG -> TACGAGTAACTTTCCTTGC
AACTGTTTAGCCGCCTACT -> ACTGTTTAGCCGCCTACTA
GCCTTAGACCTCCAGCGGT -> CCTTAGACCTCCAGCGGTT
ACCGCACACACGCGCACGG -> CCGCACACACGCGCACGGC
GACCGGGGGGCATCTAGTT -> ACCGGGGGGCATCTAGTTG
CGCAACTACGACCCGGCTT -> GCAACTACGACCCGGCTTC
TTTCGCGTTGTCACTTGGT -> TTCGCGTTGTCACTTGGTA
CGCGCGTAGTGACACGCAA -> GCGCGTAGTGACACGCAAG
TATATTCAGCAAGGATGCG -> ATATTCAGCAAGGATGCGT
GCGGAAAAGAATGAGAAAA -> CGGAAAAGAATGAGAAAAA
TAAATCACTGCACTATACT -> AAATCACTGCACTATACTC
ACACACGCGCACGGCGTCC -> CACACGCGCACGGCGTCCT
TGGCCGATACCTTGGTGGG -> GGCCGATACCTTGGTGGGA
ACCTTGATCAGTGAGGGGT -> CCTTGATCAGTGAGGGGTC
CACCTAATGAGCAACATCC -> ACCTAATGAGCAACATCCC
CTCCTACTCAACTAAAATT -> TCCTACTCAACTAAAATTC
CCTGTTCAACTATAGCGAT -> CTGTTCAACTATAGCGATA
GCGGTTAGAAACGGTGTTT -> CGGTTAGAAACGGTGTTTT
ACGCAAGCATTAGGCCAGA -> CGCAAGCATTAGGCCAGAG
AAACTGGCCGATACCTTGG -> AACTGGCCGATACCTTGGT
AGCACGAGTGTGCATGTTG -> GCACGAGTGTGCATGTTGT
TCCTATCTCAGAACTGACA -> CCTATCTCAGAACTGACAG
AAGAACCGTGCGACCCTCA -> AGAACCGTGCGACCCTCAT
CGGGCTTTTAACTGAAAGA -> GGGCTTTTAACTGAAAGAA
CGTGGCACGACGACGTCAA -> GTGGCACGACGACGTCAAA
GGAAAAGAATGAGAAAAAA -> GAAAAGAATGAGAAAAAAA
TAGAGGTCCTAACCAGGAT -> AGAGGTCCTAACCAGGATG
AGCGGTTAGAAATTTTAAG -> GCGGTTAGAAATTTTAAGT
GCCTATCGGACTCCAAATG -> CCTATCGGACTCCAAATGT
CCTAGGTATTCGTCAGCTT -> CTAGGTATTCGTCAGCTTC
GCTCCCGAAAACACCAATA -> CTCCCGAAAACACCAATAC
GGGGATGCCACGTAATTTC -> GGGATGCCACGTAATTTCC
GTGATCCCGTTCTAGTATC -> TGATCCCGTTCTAGTATCA
TGTTGTGTACTAGTGAAAA -> GTTGTGTACTAGTGAAAAG
GGCGAGCGATGAACAGCAC -> GCGAGCGATGAACAGCACT
AGGTCCTAACCAGGATGCA -> GGTCCTAACCAGGATGCAG
CATCTAGTTGGGAAAATCG -> ATCTAGTTGGGAAAATCGA
AGACCCCGACGGTAATGGT -> GACCCCGACGGTAATGGTC
TACAAGGGATGTAAAACTG -> ACAAGGGATGTAAAACTGG
CAGGGCAGCTTCCTTTTAA -> AGGGCAGCTTCCTTTTAAC
TCCTACTCAACTAAAATTC -> CCTACTCAACTAAAATTCT
TGCCTTAGACCTCCAGCGG -> GCCTTAGACCTCCAGCGGT
CCTCCAGCGGTTAGAAAAC -> CTCCAGCGGTTAGAAAACC
CACAGCGTCATATCGGCAT -> ACAGCGTCATATCGGCATG
CCGCCCCTCTTTTCCCCAG -> CGCCCCTCTTTTCCCCAGG
CGTCATATCGGCATGAGGC -> GTCATATCGGCATGAGGCT
TGGGGGATTGCCATGGTCT -> GGGGGATTGCCATGGTCTT
AACTAGGTTTCGACCGGGG -> ACTAGGTTTCGACCGGGGG
ATAAGTCACTTGTGATCCC -> TAAGTCACTTGTGATCCCG
GGGCGTACTCTCCTTCTGG -> GGCGTACTCTCCTTCTGGT
GATCAACTGTTTAGCCGCC -> ATCAACTGTTTAGCCGCCT
ACCTCCAGCGGTTAGAAAC -> CCTCCAGCGGTTAGAAACG
AGAAAGGCACATGCATACT -> GAAAGGCACATGCATACTG
ACCTTTCGCCGTGCTTCAT -> CCTTTCGCCGTGCTTCATA
CTCAACTAAAATTCTCGCC -> TCAACTAAAATTCTCGCCG
CTTCCTTTTAACCTCCAGC -> TTCCTTTTAACCTCCAGCG
GGACGGCTCCCGAAAACTA -> GACGGCTCCCGAAAACTAC
GTATTCGTCAGCTTCATTA -> TATTCGTCAGCTTCATTAT
ATGCCACACGGGCTTTTAA -> TGCCACACGGGCTTTTAAC
GCTCCCGAAAAATTTTGAG -> CTCCCGAAAAATTTTGAGG
TTTTCCCCAGGACCTCTTT -> TTTCCCCAGGACCTCTTTG
TGCTAAGCTAATGATCCGA -> GCTAAGCTAATGATCCGAG
CACTTGCATCCAGCGGCGA -> ACTTGCATCCAGCGGCGAT
CGGCGTCCTGTGTTATCGT -> GGCGTCCTGTGTTATCGTC
ACGGCGTCCTGTGTTATCG -> CGGCGTCCTGTGTTATCGT
GATCACAACGTTCTAATGC -> ATCACAACGTTCTAATGCA
TAAGCTAATGATCCGAGCC -> AAGCTAATGATCCGAGCCA
TTAGAAAACCGTTGGGTGA -> TAGAAAACCGTTGGGTGAC
TAAGCGCGCGTAGTGACAC -> AAGCGCGCGTAGTGACACG
TACGGATTGTGAGACCACC -> ACGGATTGTGAGACCACCT
ATTTAATTTAGTGAACACG -> TTTAATTTAGTGAACACGT
CACGATTTAGAGGTCCTAA -> ACGATTTAGAGGTCCTAAC
GTGTCCTGTTACAACCCAC -> TGTCCTGTTACAACCCACC
CACGCGCACGGCGTCCTGT -> ACGCGCACGGCGTCCTGTG
TAATCCCGTGTCCTGTTAC -> AATCCCGTGTCCTGTTACA
AGACCACCTCCAGCGGTTA -> GACCACCTCCAGCGGTTAG
CTTCTGGTTATTTAGGTAT -> TTCTGGTTATTTAGGTATC
TCAGTGAGGGGTCAGAACT -> CAGTGAGGGGTCAGAACTA
CTAATACCTGTTGTGTACT -> TAATACCTGTTGTGTACTA
AACCAGGATGCAGACTCCG -> ACCAGGATGCAGACTCCGT
GTAATGCCACACGGGCTTT -> TAATGCCACACGGGCTTTT
TGGACGGCTCCCGAAAACT -> GGACGGCTCCCGAAAACTA
GGTATTCGTCAGCTTCATT -> GTATTCGTCAGCTTCATTA
CCCTCTTTTCCCCAGGACC -> CCTCTTTTCCCCAGGACCT
CTACCAGTGGATCACTAGG -> TACCAGTGGATCACTAGGG
CGGAAAAGAATGAGAAAAA -> GGAAAAGAATGAGAAAAAA
CTAGGTTTCGACCGGGGGG -> TAGGTTTCGACCGGGGGGC
GCGGCGATATAAGCGCGCG -> CGGCGATATAAGCGCGCGT
CGTACTCTCCTTCTGGTTA -> GTACTCTCCTTCTGGTTAT
CTTCATTATTGGTTCAATG -> TTCATTATTGGTTCAATGT
TGCCACGTAATTTCCATCA -> GCCACGTAATTTCCATCAG
ACGACGACGTCAAAATGGT -> CGACGACGTCAAAATGGTG
TGATCCGAGCCACCCTCCA -> GATCCGAGCCACCCTCCAG
GTAATCCCGTGTCCTGTTA -> TAATCCCGTGTCCTGTTAC
CCCGAAAACTACTGTCAGG -> CCGAAAACTACTGTCAGGG
ACGGATACTCTGGAATAAG -> CGGATACTCTGGAATAAGC
AGCTTCCTTTTAACCTCCA -> GCTTCCTTTTAACCTCCAG
GTCTTATGTAATGCCACAC -> TCTTATGTAATGCCACACG
CCCAAGCTAGATCAACTGT -> CCAAGCTAGATCAACTGTT
CACACACGCGCACGGCGTC -> ACACACGCGCACGGCGTCC
TCTGAAGCCCGCCATGAGA -> CTGAAGCCCGCCATGAGAC
AGTAACTTTCCTTGCCCCA -> GTAACTTTCCTTGCCCCAA
TCCAGCTACCTCCAGCGGT -> CCAGCTACCTCCAGCGGTT
CGATTTAGAGGTCCTAACC -> GATTTAGAGGTCCTAACCA
CACCTCCAGCGGTTAGAAA -> ACCTCCAGCGGTTAGAAAC
TTGGTACGAGTAACTTTCC -> TGGTACGAGTAACTTTCCT
TTAATTTAGTGAACACGTA -> TAATTTAGTGAACACGTAT
AAGGGATGTAAAACTGGCC -> AGGGATGTAAAACTGGCCG
GGCAAGGGGATGCCACGTA -> GCAAGGGGATGCCACGTAA
GACTCCGTCAACCGACGCC -> ACTCCGTCAACCGACGCCG
TATGTAATGCCACACGGGC -> ATGTAATGCCACACGGGCT
AAAACTGCGTAATCCCGTG -> AAACTGCGTAATCCCGTGT
GCGTTGGGCAAGGGGATGC -> CGTTGGGCAAGGGGATGCC
ATCCCCAGTTCGGATACAA -> TCCCCAGTTCGGATACAAG
AAAAATTTTGAGGTCTGGG -> AAAATTTTGAGGTCTGGGA
TCCCGAAAATACACACCCA -> CCCGAAAATACACACCCAT
AACCGTTGGGTGACTGGAC -> ACCGTTGGGTGACTGGACG
TAGGTCTTGGATCACAACG -> AGGTCTTGGATCACAACGT
CTGGACGGCTCCCGAAAAA -> TGGACGGCTCCCGAAAAAT
GTTCCGCAACATATGCTAA -> TTCCGCAACATATGCTAAG
TCGTTCAGACTGGGGCGGG -> CGTTCAGACTGGGGCGGGG
CCGCAATATGTGTAGGTCT -> CGCAATATGTGTAGGTCTT
GCTCTGGTACGGATACTCT -> CTCTGGTACGGATACTCTG
TAGGTTTCGACCGGGGGGC -> AGGTTTCGACCGGGGGGCA
TGGTTATTTAGGTATCTAA -> GGTTATTTAGGTATCTAAG
TACTACTCCAGGGAAGCTG -> ACTACTCCAGGGAAGCTGT
TGTTCCGCAACATATGCTA -> GTTCCGCAACATATGCTAA
AACTACGACCCGGCTTCAT -> ACTACGACCCGGCTTCATG
GTCCGTGTAGTTCCTTGCT -> TCCGTGTAGTTCCTTGCTA
GAGAACGAAGGTCCATGCA -> AGAACGAAGGTCCATGCAG
CCGATACAACCTTGATCAG -> CGATACAACCTTGATCAGT
GAGTAGTGGAGCTTGTCCG -> AGTAGTGGAGCTTGTCCGT
GCGTTGTCACTTGGTACGA -> CGTTGTCACTTGGTACGAG
TCTTTGCTAATACCTGTTG -> CTTTGCTAATACCTGTTGT
TTCTAATGCATAAGTCACT -> TCTAATGCATAAGTCACTT
CTGGTTCATGCGATATTTT -> TGGTTCATGCGATATTTTC
CCAATACCGATACAACCTT -> CAATACCGATACAACCTTG
AACTGGCCGATACCTTGGT -> ACTGGCCGATACCTTGGTG
GGCGATATAAGCGCGCGTA -> GCGATATAAGCGCGCGTAG
ACGAGGAAAGACCGGACTG -> CGAGGAAAGACCGGACTGG
TCAGAGCTAGTTTTAAGTG -> CAGAGCTAGTTTTAAGTGA
GCTAAATGCCCTCGCGCAC -> CTAAATGCCCTCGCGCACA
ATCTTTAGCCGACCTTACG -> TCTTTAGCCGACCTTACGG
AAGCGCGCGTAGTGACACG -> AGCGCGCGTAGTGACACGC
AATGTCCCCGTGGCACGAC -> ATGTCCCCGTGGCACGACG
TAAGCAACGAGACCGCGCA -> AAGCAACGAGACCGCGCAT
TCGCCGTGCTTTCCCAAGC -> CGCCGTGCTTTCCCAAGCT
AGGATGCGTTGGGCAAGGG -> GGATGCGTTGGGCAAGGGG
TGTTCAACTATAGCGATAG -> GTTCAACTATAGCGATAGT
CGACCTTACGGATTGTGAG -> GACCTTACGGATTGTGAGA
CATGAGGCTAGGAAGAACC -> ATGAGGCTAGGAAGAACCG
GGAGAACGAAGGTCCATGC -> GAGAACGAAGGTCCATGCA
TCTATTAAGCATTCCATCT -> CTATTAAGCATTCCATCTG
TGCGTAATCCCGTGTCCTG -> GCGTAATCCCGTGTCCTGT
TTATGGGGCCAAGCAGTTG -> TATGGGGCCAAGCAGTTGC
CACATGCATACTGGACGGC -> ACATGCATACTGGACGGCT
GACTCGTTCAGACTGGGGC -> ACTCGTTCAGACTGGGGCG
ATTATTGGTTCAATGTCCC -> TTATTGGTTCAATGTCCCT
CTCTTTTCCCCAGGACCTC -> TCTTTTCCCCAGGACCTCT
ATTCCATCTGAACATCGGG -> TTCCATCTGAACATCGGGC
ACGGCTCCCGAAAAATTTT -> CGGCTCCCGAAAAATTTTG
CTTTAGTAGCGTAGTAGGG -> TTTAGTAGCGTAGTAGGGA
GGTCTGGGAGGGGAGAACC -> GTCTGGGAGGGGAGAACCT
AAGAAGTATGCCTTAGACC -> AGAAGTATGCCTTAGACCT
GGGGGCATCTAGTTGGGAA -> GGGGCATCTAGTTGGGAAA
TGTTTAGCCGCCTACTACT -> GTTTAGCCGCCTACTACTC
GGGCAGCTTCCTTTTAACC -> GGCAGCTTCCTTTTAACCT
TATATATCGCGTTAGGTTC -> ATATATCGCGTTAGGTTCA
TCCGTGTAGTTCCTTGCTA -> CCGTGTAGTTCCTTGCTAC
GAAGTATGCCTTAGACCTC -> AAGTATGCCTTAGACCTCC
CACCAATACCGATACAACC -> ACCAATACCGATACAACCT
CGATAGTGGTCGCTACAGT -> GATAGTGGTCGCTACAGTT
GCACGGCGTCCTGTGTTAT -> CACGGCGTCCTGTGTTATC
GTGAGACCACCTCCAGCGG -> TGAGACCACCTCCAGCGGT
TGAAATCTTTAGCCGACCT -> GAAATCTTTAGCCGACCTT
TTTGAGGTCTGGGAGGGGA -> TTGAGGTCTGGGAGGGGAG
GCGGCCCAAACCGTTGAGA -> CGGCCCAAACCGTTGAGAA
CCAGCGGTTAGAAAGGCAC -> CAGCGGTTAGAAAGGCACA
GATGTGCAAATTAGCGATA -> ATGTGCAAATTAGCGATAT
ACTAGTGAAAAGAAGCTCC -> CTAGTGAAAAGAAGCTCCA
CTAAGAAGTATGCCTTAGA -> TAAGAAGTATGCCTTAGAC
CCGGACTGGCACTAAATGA -> CGGACTGGCACTAAATGAC
GCCCCAACATCTTAGCTTC -> CCCCAACATCTTAGCTTCC
GATATATATCGCGTTAGGT -> ATATATATCGCGTTAGGTT
GACCTGGAAAGGGCCCAAG -> ACCTGGAAAGGGCCCAAGC
TTTCAACTGGACGGCTCCC -> TTCAACTGGACGGCTCCCG
GCTCGTGTGGACCCGACCA -> CTCGTGTGGACCCGACCAC
GTCCCCGTGGCACGACGAC -> TCCCCGTGGCACGACGACG
GAAAACTACTGTCAGGGAA -> AAAACTACTGTCAGGGAAC
GGATTGTGAGACCACCTCC -> GATTGTGAGACCACCTCCA
ATGAGACTGGTTATGGGGC -> TGAGACTGGTTATGGGGCC
CATGAGACTGGTTATGGGG -> ATGAGACTGGTTATGGGGC
CGGCTTCATGTTCCGCAAC -> GGCTTCATGTTCCGCAACA
GACCTTTCGCCGTGCTTCA -> ACCTTTCGCCGTGCTTCAT
TGTGTAGGTCTTGGATCAC -> GTGTAGGTCTTGGATCACA
GGTTCATGCGATATTTTCG -> GTTCATGCGATATTTTCGC
TTCCGCAACATATGCTAAG -> TCCGCAACATATGCTAAGC
AGCCTAGGTATTCGTCAGC -> GCCTAGGTATTCGTCAGCT
TGACTCGTTCAGACTGGGG -> GACTCGTTCAGACTGGGGC
CAAACCGTTGAGAACACGA -> AAACCGTTGAGAACACGAG
GCACGAGTGTGCATGTTGT -> CACGAGTGTGCATGTTGTT
GCGGGGTCCTATCTCAGAA -> CGGGGTCCTATCTCAGAAC
GAAAGAAGTTCTTAGCTCG -> AAAGAAGTTCTTAGCTCGT
AAATTTTGAGGTCTGGGAG -> AATTTTGAGGTCTGGGAGG
GTTGTAGTTCCCCCATCTA -> TTGTAGTTCCCCCATCTAT
TAGTAAGCAACGAGACCGC -> AGTAAGCAACGAGACCGCG
CTATCGGACTCCAAATGTC -> TATCGGACTCCAAATGTCC
GGGACCCACTTGCATCCAG -> GGACCCACTTGCATCCAGC
TTTAATTTAGTGAACACGT -> TTAATTTAGTGAACACGTA
TTTAGAGGTCCTAACCAGG -> TTAGAGGTCCTAACCAGGA
AATGTCCCTTCACCCACAT -> ATGTCCCTTCACCCACATT
CCGACGGTAATGGTCCGTG -> CGACGGTAATGGTCCGTGG
GTAGGGAGAACGAAGGTCC -> TAGGGAGAACGAAGGTCCA
AAAGAATGAGAAAAAAACT -> AAGAATGAGAAAAAAACTG
ACCCCTGTTCAACTATAGC -> CCCCTGTTCAACTATAGCG
CGTCAGCTTCATTATTGGT -> GTCAGCTTCATTATTGGTT
CGAAAATACACACCCATAC -> GAAAATACACACCCATACA
AGCAGTTGCTGAAATCTTT -> GCAGTTGCTGAAATCTTTA
GACCCTCATCAAGTGCGTG -> ACCCTCATCAAGTGCGTGG
AATACCGATACAACCTTGA -> ATACCGATACAACCTTGAT
TCAAGTGCGTGGTACAATT -> CAAGTGCGTGGTACAATTT
GCGACCCTCATCAAGTGCG -> CGACCCTCATCAAGTGCGT
AGTTGCTGAAATCTTTAGC -> GTTGCTGAAATCTTTAGCC
CCGGGGGGCATCTAGTTGG -> CGGGGGGCATCTAGTTGGG
ACTCGCGGCCCAAACCGTT -> CTCGCGGCCCAAACCGTTG
TGCTTTCCCAAGCTAGATC -> GCTTTCCCAAGCTAGATCA
GCATACTGGACGGCTCCCG -> CATACTGGACGGCTCCCGA
CTCCAGCGGTTAGAAACGG -> TCCAGCGGTTAGAAACGGT
TTCAGCAAGGATGCGTTGG -> TCAGCAAGGATGCGTTGGG
CCTGAGTTCCATCTGTCAC -> CTGAGTTCCATCTGTCACG
GCAGGAGCTCTGAAGCCCG -> CAGGAGCTCTGAAGCCCGC
GGCACGACGACGTCAAAAT -> GCACGACGACGTCAAAATG
ATGCGTTGGGCAAGGGGAT -> TGCGTTGGGCAAGGGGATG
TCCCCAGGACCTCTTTGCT -> CCCCAGGACCTCTTTGCTA
GGTTCAATGTCCCTTCACC -> GTTCAATGTCCCTTCACCC
GCTTTTAACTGAAAGAAGT -> CTTTTAACTGAAAGAAGTT
TCCAGCGGTTAGAAAGGCA -> CCAGCGGTTAGAAAGGCAC
TTAGAAACGGTGTTTTCAA -> TAGAAACGGTGTTTTCAAC
TCGACCGGGGGGCATCTAG -> CGACCGGGGGGCATCTAGT
GTTAGGTTCAGTAGAGCGG -> TTAGGTTCAGTAGAGCGGA
ACCCGGCTTCATGTTCCGC -> CCCGGCTTCATGTTCCGCA
CTGTCACGATTTAGAGGTC -> TGTCACGATTTAGAGGTCC
TGGTCGCTACAGTTACCCG -> GGTCGCTACAGTTACCCGC
AAAAACTGCGTAATCCCGT -> AAAACTGCGTAATCCCGTG
CCTTGCCCCAACATCTTAG -> CTTGCCCCAACATCTTAGC
TCTTTTCCCCAGGACCTCT -> CTTTTCCCCAGGACCTCTT
AGGTATCTAAGGAGTAGTG -> GGTATCTAAGGAGTAGTGG
GAACACTCCGCCCCTCTTT -> AACACTCCGCCCCTCTTTT
TACACACCCATACATAGCA -> ACACACCCATACATAGCAC
TCGGACTGGACGGCTCCCG -> CGGACTGGACGGCTCCCGA
GTGCATGTTGTTGACTCGT -> TGCATGTTGTTGACTCGTT
GCATGACCAGGCTCTGGTA -> CATGACCAGGCTCTGGTAC
CATCTATTAAGCATTCCAT -> ATCTATTAAGCATTCCATC
GCAACTAGCCTAGGTATTC -> CAACTAGCCTAGGTATTCG
CAACATATGCTAAGCTAAT -> AACATATGCTAAGCTAATG
GCATTAGACCCCGACGGTA -> CATTAGACCCCGACGGTAA
GTTTCGACCGGGGGGCATC -> TTTCGACCGGGGGGCATCT
CGATACCTTGGTGGGAGAA -> GATACCTTGGTGGGAGAAA
GTGGGACCCACTTGCATCC -> TGGGACCCACTTGCATCCA
GGTGACTGGACGGCTCCCG -> GTGACTGGACGGCTCCCGA
GAACATCGGGCGTACTCTC -> AACATCGGGCGTACTCTCC
CCCACTTGCATCCAGCGGC -> CCACTTGCATCCAGCGGCG
TCACCTAATGAGCAACATC -> CACCTAATGAGCAACATCC
GGACCCGACCACGACGGAG -> GACCCGACCACGACGGAGG
CAGTGAGGGGTCAGAACTA -> AGTGAGGGGTCAGAACTAG
CTAATGAGCAACATCCCCA -> TAATGAGCAACATCCCCAG
TTTCCTTGCCCCAACATCT -> TTCCTTGCCCCAACATCTT
AGTTCCTTGCTACTGGGGG -> GTTCCTTGCTACTGGGGGA
TCCTTGCCCCAACATCTTA -> CCTTGCCCCAACATCTTAG
GTTGTTGACTCGTTCAGAC -> TTGTTGACTCGTTCAGACT
ACGGCTCCCGAAAACTACT -> CGGCTCCCGAAAACTACTG
GCGGTTAGAAAGGCACATG -> CGGTTAGAAAGGCACATGC
AAAGGCACATGCATACTGG -> AAGGCACATGCATACTGGA
CTTTCCTTGCCCCAACATC -> TTTCCTTGCCCCAACATCT
TCTGGAATAAGCGAGTGCC -> CTGGAATAAGCGAGTGCCG
GCAACGAGACCGCGCATCT -> CAACGAGACCGCGCATCTT
GAACACGAGGAAAGACCGG -> AACACGAGGAAAGACCGGA
AATGCGCCTATCGGACTCC -> ATGCGCCTATCGGACTCCA
CTTTAGCCGACCTTACGGA -> TTTAGCCGACCTTACGGAT
TGTTATCGTCAACTACAGC -> GTTATCGTCAACTACAGCA
CTGGAATAAGCGAGTGCCG -> TGGAATAAGCGAGTGCCGC
AATACCGCACACACGCGCA -> ATACCGCACACACGCGCAC
AAAAAACTGCGTAATCCCG -> AAAAACTGCGTAATCCCGT
ATCAACTGTTTAGCCGCCT -> TCAACTGTTTAGCCGCCTA
TTGCCCCAACATCTTAGCT -> TGCCCCAACATCTTAGCTT
TGGTCTTATGTAATGCCAC -> GGTCTTATGTAATGCCACA
ACACGAGGAAAGACCGGAC -> CACGAGGAAAGACCGGACT
ATGTGCAAATTAGCGATAT -> TGTGCAAATTAGCGATATA
TATTTAGGTATCTAAGGAG -> ATTTAGGTATCTAAGGAGT
AGACCTCCAGCGGTTAGAA -> GACCTCCAGCGGTTAGAAA
TCTCAGAACTGACAGGCAT -> CTCAGAACTGACAGGCATG
GTGAGCTACCAGTGGATCA -> TGAGCTACCAGTGGATCAC
CCCAGGACCTCTTTGCTAA -> CCAGGACCTCTTTGCTAAT
CCCGCCATGAGACTGGTTA -> CCGCCATGAGACTGGTTAT
CCCGGCTTCATGTTCCGCA -> CCGGCTTCATGTTCCGCAA
CAGAACTGACAGGCATGAC -> AGAACTGACAGGCATGACC
TAGAAAGGCACATGCATAC -> AGAAAGGCACATGCATACT
GTGTTATCGTCAACTACAG -> TGTTATCGTCAACTACAGC
ATATTTTCGCGTTGTCACT -> TATTTTCGCGTTGTCACTT
CTCCAGCGGTTAGAAAACC -> TCCAGCGGTTAGAAAACCG
CATCACAGCGTCATATCGG -> ATCACAGCGTCATATCGGC
CGACCGGGGGGCATCTAGT -> GACCGGGGGGCATCTAGTT
CTTCACCCACATTATAGTA -> TTCACCCACATTATAGTAA
CCGCTTTAGTAGCGTAGTA -> CGCTTTAGTAGCGTAGTAG
TGGGTGTGCGCCGCATGTT -> GGGTGTGCGCCGCATGTTG
AGGGAGAACGAAGGTCCAT -> GGGAGAACGAAGGTCCATG
TCCCAAGCTAGATCAACTG -> CCCAAGCTAGATCAACTGT
CACCTAAGAAGTATGCCTT -> ACCTAAGAAGTATGCCTTA
AAGCAGTTGCTGAAATCTT -> AGCAGTTGCTGAAATCTTT
TTCAACTATAGCGATAGTG -> TCAACTATAGCGATAGTGG
CTACTCCAGGGAAGCTGTA -> TACTCCAGGGAAGCTGTAT
GAGCGATGAACAGCACTCG -> AGCGATGAACAGCACTCGC
AACCTTGATCAGTGAGGGG -> ACCTTGATCAGTGAGGGGT
CTAAGGAGTAGTGGAGCTT -> TAAGGAGTAGTGGAGCTTG
AGTGGTCGCTACAGTTACC -> GTGGTCGCTACAGTTACCC
GCCGTGCTTCATAGTCTGG -> CCGTGCTTCATAGTCTGGA
CACACCCATACATAGCACG -> ACACCCATACATAGCACGA
ATTGCCATGGTCTTATGTA -> TTGCCATGGTCTTATGTAA
GACCCACTTGCATCCAGCG -> ACCCACTTGCATCCAGCGG
CCGAAAATACACACCCATA -> CGAAAATACACACCCATAC
ACACGTATAAACTTTTATG -> CACGTATAAACTTTTATGC
TATCTCAGAACTGACAGGC -> ATCTCAGAACTGACAGGCA
GCTACAGTTACCCGCAACT -> CTACAGTTACCCGCAACTA
TCCTAACCAGGATGCAGAC -> CCTAACCAGGATGCAGACT
GCAGTTGCTGAAATCTTTA -> CAGTTGCTGAAATCTTTAG
CACCCCTGTTCAACTATAG -> ACCCCTGTTCAACTATAGC
CTAATGATCCGAGCCACCC -> TAATGATCCGAGCCACCCT
CGCAACATATGCTAAGCTA -> GCAACATATGCTAAGCTAA
CCGCCTACTACTCCAGGGA -> CGCCTACTACTCCAGGGAA
GAAAATACACACCCATACA -> AAAATACACACCCATACAT
ATGAGAAAAAAACTGCGTA -> TGAGAAAAAAACTGCGTAA
CCCCAACATCTTAGCTTCC -> CCCAACATCTTAGCTTCCT
GTCCTGTGTTATCGTCAAC -> TCCTGTGTTATCGTCAACT
ACGTATAAACTTTTATGCT -> CGTATAAACTTTTATGCTA
ATATGTGTAGGTCTTGGAT -> TATGTGTAGGTCTTGGATC
AAATTAGCGATATATATCG -> AATTAGCGATATATATCGC
ACGTTCTAATGCATAAGTC -> CGTTCTAATGCATAAGTCA
GGCACTAAATGACCTTTCG -> GCACTAAATGACCTTTCGC
CCCTCGCGCACACCCCTGT -> CCTCGCGCACACCCCTGTT
CAGTAGAGCGGAAAAGAAT -> AGTAGAGCGGAAAAGAATG
CCGTGCTTCATAGTCTGGA -> CGTGCTTCATAGTCTGGAA
CTAAGCTAATGATCCGAGC -> TAAGCTAATGATCCGAGCC
GTATAAACTTTTATGCTAA -> TATAAACTTTTATGCTAAA
TGCAAATTAGCGATATATA -> GCAAATTAGCGATATATAT
AGAAAACCGTTGGGTGACT -> GAAAACCGTTGGGTGACTG
GGGGTCCTATCTCAGAACT -> GGGTCCTATCTCAGAACTG
TAGGGAGAACGAAGGTCCA -> AGGGAGAACGAAGGTCCAT
TTCATGTTCCGCAACATAT -> TCATGTTCCGCAACATATG
CTGAAGCCCGCCATGAGAC -> TGAAGCCCGCCATGAGACT
GAAAATCGACTAAATCACT -> AAAATCGACTAAATCACTG
TGTAGTTCCCCCATCTATT -> GTAGTTCCCCCATCTATTA
TCCTTGCTACTGGGGGATT -> CCTTGCTACTGGGGGATTG
ACTTTTATGCTAAATGCCC -> CTTTTATGCTAAATGCCCT
ATGGCTAATTCAGAGCTAG -> TGGCTAATTCAGAGCTAGT
GTGGTACAATTTAATTTAG -> TGGTACAATTTAATTTAGT
GCACTAGCCAGTGAGCTAC -> CACTAGCCAGTGAGCTACC
GTCAACCGACGCCGCACGC -> TCAACCGACGCCGCACGCT
CCTGTGTTATCGTCAACTA -> CTGTGTTATCGTCAACTAC
CTCCTTCTGGTTATTTAGG -> TCCTTCTGGTTATTTAGGT
CGCGTTGTCACTTGGTACG -> GCGTTGTCACTTGGTACGA
AACATCACAGCGTCATATC -> ACATCACAGCGTCATATCG
GGATGCCACGTAATTTCCA -> GATGCCACGTAATTTCCAT
GACCCGACCACGACGGAGG -> ACCCGACCACGACGGAGGA
TAGCACGAGTGTGCATGTT -> AGCACGAGTGTGCATGTTG
CAAGCAGTTGCTGAAATCT -> AAGCAGTTGCTGAAATCTT
GGCTCCCGAAAACACCAAT -> GCTCCCGAAAACACCAATA
GCAATGAGGACCAAGAACC -> CAATGAGGACCAAGAACCG
AGGGAAGCTGTATGGCTAA -> GGGAAGCTGTATGGCTAAT
GTTTTCAACTGGACGGCTC -> TTTTCAACTGGACGGCTCC
AAAAGAAGCTCCAGACCTG -> AAAGAAGCTCCAGACCTGG
TGGTGGGAGAAAAGGGAAC -> GGTGGGAGAAAAGGGAACA
TAGAGCGGAAAAGAATGAG -> AGAGCGGAAAAGAATGAGA
CCAAATGTCCCCGTGGCAC -> CAAATGTCCCCGTGGCACG
GGATACTCTGGAATAAGCG -> GATACTCTGGAATAAGCGA
GACGGAGGACTCAGTAATA -> ACGGAGGACTCAGTAATAC
TTTAGCCGACCTTACGGAT -> TTAGCCGACCTTACGGATT
GGGCCAAGCAGTTGCTGAA -> GGCCAAGCAGTTGCTGAAA
TAGTCTGGAAGGCAACTAG -> AGTCTGGAAGGCAACTAGC
TTGGGTGACTGGACGGCTC -> TGGGTGACTGGACGGCTCC
CTAATGCATAAGTCACTTG -> TAATGCATAAGTCACTTGT
CGGTGTTTTCAACTGGACG -> GGTGTTTTCAACTGGACGG
TGAGAACACGAGGAAAGAC -> GAGAACACGAGGAAAGACC
CGTGTCCTGTTACAACCCA -> GTGTCCTGTTACAACCCAC
TTGTAGTTCCCCCATCTAT -> TGTAGTTCCCCCATCTATT
GAACCTGAGTTCCATCTGT -> AACCTGAGTTCCATCTGTC
TTCTTAGCTCGTGTGGACC -> TCTTAGCTCGTGTGGACCC
CTAAATGCCCTCGCGCACA -> TAAATGCCCTCGCGCACAC
TCGGACTCCAAATGTCCCC -> CGGACTCCAAATGTCCCCG
TCGACTAAATCACTGCACT -> CGACTAAATCACTGCACTA
ACTGGCCGATACCTTGGTG -> CTGGCCGATACCTTGGTGG
TAGACCCCGACGGTAATGG -> AGACCCCGACGGTAATGGT
TTCGGATACAAGGGATGTA -> TCGGATACAAGGGATGTAA
AGCTCGTGTGGACCCGACC -> GCTCGTGTGGACCCGACCA
CGCCCCTCTTTTCCCCAGG -> GCCCCTCTTTTCCCCAGGA
CCACCTCCAGCGGTTAGAA -> CACCTCCAGCGGTTAGAAA
TAGTGAACACGTATAAACT -> AGTGAACACGTATAAACTT
GGATTGCCATGGTCTTATG -> GATTGCCATGGTCTTATGT
CTAGCCAGTGAGCTACCAG -> TAGCCAGTGAGCTACCAGT
CCCCGACGGTAATGGTCCG -> CCCGACGGTAATGGTCCGT
AAATACACACCCATACATA -> AATACACACCCATACATAG
CCGACCTTACGGATTGTGA -> CGACCTTACGGATTGTGAG
GGTTATTTAGGTATCTAAG -> GTTATTTAGGTATCTAAGG
TTCGCGTTGTCACTTGGTA -> TCGCGTTGTCACTTGGTAC
ACGCTATGTTCGCAGGAGC -> CGCTATGTTCGCAGGAGCT
ACGGCCACTGCACTAGCCA -> CGGCCACTGCACTAGCCAG
GTTCAGACTGGGGCGGGGT -> TTCAGACTGGGGCGGGGTC
CTTGTCCGTGTAGTTCCTT -> TTGTCCGTGTAGTTCCTTG
AAGAATGAGAAAAAAACTG -> AGAATGAGAAAAAAACTGC
ACGAGTAACTTTCCTTGCC -> CGAGTAACTTTCCTTGCCC
CTTGATCAGTGAGGGGTCA -> TTGATCAGTGAGGGGTCAG
CGAGTATATTCAGCAAGGA -> GAGTATATTCAGCAAGGAT
GACCTCTTTGCTAATACCT -> ACCTCTTTGCTAATACCTG
TTGACTCGTTCAGACTGGG -> TGACTCGTTCAGACTGGGG
TTTCCCAAGCTAGATCAAC -> TTCCCAAGCTAGATCAACT
CCTCCAGCTACCTCCAGCG -> CTCCAGCTACCTCCAGCGG
TGACCAGGCTCTGGTACGG -> GACCAGGCTCTGGTACGGA
TGGCTAATTCAGAGCTAGT -> GGCTAATTCAGAGCTAGTT
TCATCAAGTGCGTGGTACA -> CATCAAGTGCGTGGTACAA
CTATAGCGATAGTGGTCGC -> TATAGCGATAGTGGTCGCT
AAATCGACTAAATCACTGC -> AATCGACTAAATCACTGCA
AACGGTGTTTTCAACTGGA -> ACGGTGTTTTCAACTGGAC
ACTTGCATCCAGCGGCGAT -> CTTGCATCCAGCGGCGATA
CGAAAAATTTTGAGGTCTG -> GAAAAATTTTGAGGTCTGG
AACGTTCTAATGCATAAGT -> ACGTTCTAATGCATAAGTC
CGATATTTTCGCGTTGTCA -> GATATTTTCGCGTTGTCAC
ATTGTGAGACCACCTCCAG -> TTGTGAGACCACCTCCAGC
ACAGCACTCGCAATGAAGG -> CAGCACTCGCAATGAAGGG
CGGGCGTACTCTCCTTCTG -> GGGCGTACTCTCCTTCTGG
ATCGCGTTAGGTTCAGTAG -> TCGCGTTAGGTTCAGTAGA
GAAAACACCAATACCGATA -> AAAACACCAATACCGATAC
CTGGTTATTTAGGTATCTA -> TGGTTATTTAGGTATCTAA
CACGGCGTCCTGTGTTATC -> ACGGCGTCCTGTGTTATCG
GCTTTAGTAGCGTAGTAGG -> CTTTAGTAGCGTAGTAGGG
CGAGCCACCCTCCAGCTAC -> GAGCCACCCTCCAGCTACC
CGACGCCGCACGCTATGTT -> GACGCCGCACGCTATGTTC
GAAATCTTTAGCCGACCTT -> AAATCTTTAGCCGACCTTA
AACAGCACTCGCAATGAAG -> ACAGCACTCGCAATGAAGG
AGACTCCGTCAACCGACGC -> GACTCCGTCAACCGACGCC
CAGCAATGAGGACCAAGAA -> AGCAATGAGGACCAAGAAC
CATCTGTCACGATTTAGAG -> ATCTGTCACGATTTAGAGG
CGCCGCACGCTATGTTCGC -> GCCGCACGCTATGTTCGCA
GCCGCAATATGTGTAGGTC -> CCGCAATATGTGTAGGTCT
CATGTTGTAGTTCCCCCAT -> ATGTTGTAGTTCCCCCATC
GGACCCACTTGCATCCAGC -> GACCCACTTGCATCCAGCG
CCTCTTTTCCCCAGGACCT -> CTCTTTTCCCCAGGACCTC
ACCACCTCCAGCGGTTAGA -> CCACCTCCAGCGGTTAGAA
TTGGATCACAACGTTCTAA -> TGGATCACAACGTTCTAAT
TCCCCGTGGCACGACGACG -> CCCCGTGGCACGACGACGT
GAGGGGAGAACCTACTGGT -> AGGGGAGAACCTACTGGTT
TACCTTGGTGGGAGAAAAG -> ACCTTGGTGGGAGAAAAGG
AATTTTAAGTCGGACTGGA -> ATTTTAAGTCGGACTGGAC
CGGCATGAGGCTAGGAAGA -> GGCATGAGGCTAGGAAGAA
GTACGGATACTCTGGAATA -> TACGGATACTCTGGAATAA
ATGAGCAACATCCCCAGTT -> TGAGCAACATCCCCAGTTC
GACGGCTCCCGAAAAATTT -> ACGGCTCCCGAAAAATTTT
CATCTTACTTTCAACGGCC -> ATCTTACTTTCAACGGCCA
GGGATCCGCTTTAGTAGCG -> GGATCCGCTTTAGTAGCGT
TCCTCACCTAATGAGCAAC -> CCTCACCTAATGAGCAACA
GGGAGAACGAAGGTCCATG -> GGAGAACGAAGGTCCATGC
TGGGGCCAAGCAGTTGCTG -> GGGGCCAAGCAGTTGCTGA
TGGAATAAGCGAGTGCCGC -> GGAATAAGCGAGTGCCGCA
AGTCGGACTGGACGGCTCC -> GTCGGACTGGACGGCTCCC
GTGACACGCAAGCATTAGG -> TGACACGCAAGCATTAGGC
ACTATACTCGCGGCCCAAA -> CTATACTCGCGGCCCAAAC
TTCGACCGGGGGGCATCTA -> TCGACCGGGGGGCATCTAG
GAAATGCGCCTATCGGACT -> AAATGCGCCTATCGGACTC
CGTCAACCGACGCCGCACG -> GTCAACCGACGCCGCACGC
GGATGTAAAACTGGCCGAT -> GATGTAAAACTGGCCGATA
GCAACTACGACCCGGCTTC -> CAACTACGACCCGGCTTCA
CAAGGGGATGCCACGTAAT -> AAGGGGATGCCACGTAATT
