ACTGGCATTGA -> CTGGCATTGAT
CTGGCATTGAT -> TGGCATTGATC
TGGCATTGATC -> GGCATTGATCC
GGCATTGATCC -> GCATTGATCCA
GCATTGATCCA -> CATTGATCCAC
CATTGATCCAC -> ATTGATCCACG
ATTGATCCACG -> TTGATCCACGT
TTGATCCACGT -> TGATCCACGTT
TGATCCACGTT -> GATCCACGTTA
GATCCACGTTA -> ATCCACGTTAC
ATCCACGTTAC -> TCCACGTTACT
TCCACGTTACT -> CCACGTTACTA
CCACGTTACTA -> CACGTTACTAT
CACGTTACTAT -> ACGTTACTATG
ACGTTACTATG -> CGTTACTATGC
CGTTACTATGC -> GTTACTATGCC
GTTACTATGCC -> TTACTATGCCT
TTACTATGCCT -> TACTATGCCTG
TACTATGCCTG -> ACTATGCCTGC
ACTATGCCTGC -> CTATGCCTGCA
CTATGCCTGCA -> TATGCCTGCAT
TATGCCTGCAT -> ATGCCTGCATG
ATGCCTGCATG -> TGCCTGCATGT
TGCCTGCATGT -> GCCTGCATGTC
GCCTGCATGTC -> CCTGCATGTCC
CCTGCATGTCC -> CTGCATGTCCT
CTGCATGTCCT -> TGCATGTCCTG
TGCATGTCCTG -> GCATGTCCTGT
GCATGTCCTGT -> CATGTCCTGTC
CATGTCCTGTC -> ATGTCCTGTCC
ATGTCCTGTCC -> TGTCCTGTCCT
TGTCCTGTCCT -> GTCCTGTCCTG
GTCCTGTCCTG -> TCCTGTCCTGG
TCCTGTCCTGG -> CCTGTCCTGGG
CCTGTCCTGGG -> CTGTCCTGGGC
CTGTCCTGGGC -> TGTCCTGGGCG
TGTCCTGGGCG -> GTCCTGGGCGA
GTCCTGGGCGA -> TCCTGGGCGAG
TCCTGGGCGAG -> CCTGGGCGAGG
CCTGGGCGAGG -> CTGGGCGAGGA
CTGGGCGAGGA -> TGGGCGAGGAC
TGGGCGAGGAC -> GGGCGAGGACA
GGGCGAGGACA -> GGCGAGGACAC
GGCGAGGACAC -> GCGAGGACACT
GCGAGGACACT -> CGAGGACACTT
CGAGGACACTT -> GAGGACACTTA
GAGGACACTTA -> AGGACACTTAT
AGGACACTTAT -> GGACACTTATC
GGACACTTATC -> GACACTTATCA
GACACTTATCA -> ACACTTATCAG
ACACTTATCAG -> CACTTATCAGA
CACTTATCAGA -> ACTTATCAGAT
ACTTATCAGAT -> CTTATCAGATC
CTTATCAGATC -> TTATCAGATCG
TTATCAGATCG -> TATCAGATCGC
TATCAGATCGC -> ATCAGATCGCT
ATCAGATCGCT -> TCAGATCGCTC
TCAGATCGCTC -> CAGATCGCTCC
CAGATCGCTCC -> AGATCGCTCCG
AGATCGCTCCG -> GATCGCTCCGT
GATCGCTCCGT -> ATCGCTCCGTC
ATCGCTCCGTC -> TCGCTCCGTCA
TCGCTCCGTCA -> CGCTCCGTCAC
CGCTCCGTCAC -> GCTCCGTCACA
GCTCCGTCACA -> CTCCGTCACAG
CTCCGTCACAG -> TCCGTCACAGG
TCCGTCACAGG -> CCGTCACAGGA
CCGTCACAGGA -> CGTCACAGGAC
CGTCACAGGAC -> GTCACAGGACA
GTCACAGGACA -> TCACAGGACAC
TCACAGGACAC -> CACAGGACACG
CACAGGACACG -> ACAGGACACGT
ACAGGACACGT -> CAGGACACGTC
CAGGACACGTC -> AGGACACGTCA
AGGACACGTCA -> GGACACGTCAC
GGACACGTCAC -> GACACGTCACA
GACACGTCACA -> ACACGTCACAC
ACACGTCACAC -> CACGTCACACG
CACGTCACACG -> ACGTCACACGC
ACGTCACACGC -> CGTCACACGCC
CGTCACACGCC -> GTCACACGCCG
GTCACACGCCG -> TCACACGCCGG
TCACACGCCGG -> CACACGCCGGG
CACACGCCGGG -> ACACGCCGGGG
ACACGCCGGGG -> CACGCCGGGGA
CACGCCGGGGA -> ACGCCGGGGAT
ACGCCGGGGAT -> CGCCGGGGATG
CGCCGGGGATG -> GCCGGGGATGC
GCCGGGGATGC -> CCGGGGATGCA
CCGGGGATGCA -> CGGGGATGCAA
CGGGGATGCAA -> GGGGATGCAAA
GGGGATGCAAA -> GGGATGCAAAA
GGGATGCAAAA -> GGATGCAAAAC
GGATGCAAAAC -> GATGCAAAACA
GATGCAAAACA -> ATGCAAAACAT
ATGCAAAACAT -> TGCAAAACATT
TGCAAAACATT -> GCAAAACATTG
GCAAAACATTG -> CAAAACATTGG
CAAAACATTGG -> AAAACATTGGA
AAAACATTGGA -> AAACATTGGAG
AAACATTGGAG -> AACATTGGAGT
AACATTGGAGT -> ACATTGGAGTT
ACATTGGAGTT -> CATTGGAGTTA
CATTGGAGTTA -> ATTGGAGTTAG
ATTGGAGTTAG -> TTGGAGTTAGT
TTGGAGTTAGT -> TGGAGTTAGTG
TGGAGTTAGTG -> GGAGTTAGTGT
GGAGTTAGTGT -> GAGTTAGTGTC
GAGTTAGTGTC -> AGTTAGTGTCG
AGTTAGTGTCG -> GTTAGTGTCGT
GTTAGTGTCGT -> TTAGTGTCGTG
TTAGTGTCGTG -> TAGTGTCGTGT
TAGTGTCGTGT -> AGTGTCGTGTT
AGTGTCGTGTT -> GTGTCGTGTTC
GTGTCGTGTTC -> TGTCGTGTTCG
TGTCGTGTTCG -> GTCGTGTTCGC
GTCGTGTTCGC -> TCGTGTTCGCC
TCGTGTTCGCC -> CGTGTTCGCCT
CGTGTTCGCCT -> GTGTTCGCCTT
GTGTTCGCCTT -> TGTTCGCCTTT
TGTTCGCCTTT -> GTTCGCCTTTG
GTTCGCCTTTG -> TTCGCCTTTGG
TTCGCCTTTGG -> TCGCCTTTGGA
TCGCCTTTGGA -> CGCCTTTGGAT
CGCCTTTGGAT -> GCCTTTGGATA
GCCTTTGGATA -> CCTTTGGATAA
CCTTTGGATAA -> CTTTGGATAAG
CTTTGGATAAG -> TTTGGATAAGA
TTTGGATAAGA -> TTGGATAAGAC
TTGGATAAGAC -> TGGATAAGACT
TGGATAAGACT -> GGATAAGACTA
GGATAAGACTA -> GATAAGACTAG
GATAAGACTAG -> ATAAGACTAGC
ATAAGACTAGC -> TAAGACTAGCC
TAAGACTAGCC -> AAGACTAGCCA
AAGACTAGCCA -> AGACTAGCCAG
AGACTAGCCAG -> GACTAGCCAGA
GACTAGCCAGA -> ACTAGCCAGAA
ACTAGCCAGAA -> CTAGCCAGAAC
CTAGCCAGAAC -> TAGCCAGAACA
TAGCCAGAACA -> AGCCAGAACAT
AGCCAGAACAT -> GCCAGAACATC
GCCAGAACATC -> CCAGAACATCT
CCAGAACATCT -> CAGAACATCTA
CAGAACATCTA -> AGAACATCTAA
AGAACATCTAA -> GAACATCTAAG
GAACATCTAAG -> AACATCTAAGG
AACATCTAAGG -> ACATCTAAGGA
ACATCTAAGGA -> CATCTAAGGAT
CATCTAAGGAT -> ATCTAAGGATT
ATCTAAGGATT -> TCTAAGGATTT
TCTAAGGATTT -> CTAAGGATTTT
CTAAGGATTTT -> TAAGGATTTTG
TAAGGATTTTG -> AAGGATTTTGA
AAGGATTTTGA -> AGGATTTTGAA
AGGATTTTGAA -> GGATTTTGAAA
GGATTTTGAAA -> GATTTTGAAAC
GATTTTGAAAC -> ATTTTGAAACA
ATTTTGAAACA -> TTTTGAAACAA
TTTTGAAACAA -> TTTGAAACAAG
TTTGAAACAAG -> TTGAAACAAGG
TTGAAACAAGG -> TGAAACAAGGG
TGAAACAAGGG -> GAAACAAGGGT
GAAACAAGGGT -> AAACAAGGGTA
AAACAAGGGTA -> AACAAGGGTAG
AACAAGGGTAG -> ACAAGGGTAGC
ACAAGGGTAGC -> CAAGGGTAGCG
CAAGGGTAGCG -> AAGGGTAGCGA
AAGGGTAGCGA -> AGGGTAGCGAG
AGGGTAGCGAG -> GGGTAGCGAGG
GGGTAGCGAGG -> GGTAGCGAGGG
GGTAGCGAGGG -> GTAGCGAGGGT
GTAGCGAGGGT -> TAGCGAGGGTT
TAGCGAGGGTT -> AGCGAGGGTTT
AGCGAGGGTTT -> GCGAGGGTTTT
GCGAGGGTTTT -> CGAGGGTTTTG
CGAGGGTTTTG -> GAGGGTTTTGG
GAGGGTTTTGG -> AGGGTTTTGGT
AGGGTTTTGGT -> GGGTTTTGGTT
GGGTTTTGGTT -> GGTTTTGGTTC
GGTTTTGGTTC -> GTTTTGGTTCT
GTTTTGGTTCT -> TTTTGGTTCTC
TTTTGGTTCTC -> TTTGGTTCTCC
TTTGGTTCTCC -> TTGGTTCTCCC
TTGGTTCTCCC -> TGGTTCTCCCC
TGGTTCTCCCC -> GGTTCTCCCCT
GGTTCTCCCCT -> GTTCTCCCCTC
GTTCTCCCCTC -> TTCTCCCCTCA
TTCTCCCCTCA -> TCTCCCCTCAT
TCTCCCCTCAT -> CTCCCCTCATC
CTCCCCTCATC -> TCCCCTCATCA
TCCCCTCATCA -> CCCCTCATCAT
CCCCTCATCAT -> CCCTCATCATA
CCCTCATCATA -> CCTCATCATAT
CCTCATCATAT -> CTCATCATATC
CTCATCATATC -> TCATCATATCC
TCATCATATCC -> CATCATATCCA
CATCATATCCA -> ATCATATCCAC
ATCATATCCAC -> TCATATCCACA
TCATATCCACA -> CATATCCACAA
CATATCCACAA -> ATATCCACAAC
ATATCCACAAC -> TATCCACAACT
TATCCACAACT -> ATCCACAACTA
ATCCACAACTA -> TCCACAACTAC
TCCACAACTAC -> CCACAACTACT
CCACAACTACT -> CACAACTACTT
CACAACTACTT -> ACAACTACTTC
ACAACTACTTC -> CAACTACTTCA
CAACTACTTCA -> AACTACTTCAT
AACTACTTCAT -> ACTACTTCATG
ACTACTTCATG -> CTACTTCATGT
CTACTTCATGT -> TACTTCATGTC
TACTTCATGTC -> ACTTCATGTCT
ACTTCATGTCT -> CTTCATGTCTG
CTTCATGTCTG -> TTCATGTCTGG
TTCATGTCTGG -> TCATGTCTGGC
TCATGTCTGGC -> CATGTCTGGCA
CATGTCTGGCA -> ATGTCTGGCAA
ATGTCTGGCAA -> TGTCTGGCAAT
TGTCTGGCAAT -> GTCTGGCAATC
GTCTGGCAATC -> TCTGGCAATCG
TCTGGCAATCG -> CTGGCAATCGC
CTGGCAATCGC -> TGGCAATCGCT
TGGCAATCGCT -> GGCAATCGCTT
GGCAATCGCTT -> GCAATCGCTTG
GCAATCGCTTG -> CAATCGCTTGC
CAATCGCTTGC -> AATCGCTTGCC
AATCGCTTGCC -> ATCGCTTGCCT
ATCGCTTGCCT -> TCGCTTGCCTG
TCGCTTGCCTG -> CGCTTGCCTGG
CGCTTGCCTGG -> GCTTGCCTGGC
GCTTGCCTGGC -> CTTGCCTGGCT
CTTGCCTGGCT -> TTGCCTGGCTG
TTGCCTGGCTG -> TGCCTGGCTGA
TGCCTGGCTGA -> GCCTGGCTGAA
GCCTGGCTGAA -> CCTGGCTGAAT
CCTGGCTGAAT -> CTGGCTGAATG
CTGGCTGAATG -> TGGCTGAATGT
TGGCTGAATGT -> GGCTGAATGTT
GGCTGAATGTT -> GCTGAATGTTG
GCTGAATGTTG -> CTGAATGTTGA
CTGAATGTTGA -> TGAATGTTGAT
TGAATGTTGAT -> GAATGTTGATT
GAATGTTGATT -> AATGTTGATTA
AATGTTGATTA -> ATGTTGATTAC
ATGTTGATTAC -> TGTTGATTACC
TGTTGATTACC -> GTTGATTACCA
GTTGATTACCA -> TTGATTACCAA
TTGATTACCAA -> TGATTACCAAC
TGATTACCAAC -> GATTACCAACC
GATTACCAACC -> ATTACCAACCA
ATTACCAACCA -> TTACCAACCAC
TTACCAACCAC -> TACCAACCACC
TACCAACCACC -> ACCAACCACCG
ACCAACCACCG -> CCAACCACCGA
CCAACCACCGA -> CAACCACCGAA
CAACCACCGAA -> AACCACCGAAG
AACCACCGAAG -> ACCACCGAAGA
ACCACCGAAGA -> CCACCGAAGAA
CCACCGAAGAA -> CACCGAAGAAT
CACCGAAGAAT -> ACCGAAGAATA
ACCGAAGAATA -> CCGAAGAATAA
CCGAAGAATAA -> CGAAGAATAAG
CGAAGAATAAG -> GAAGAATAAGC
GAAGAATAAGC -> AAGAATAAGCT
AAGAATAAGCT -> AGAATAAGCTA
AGAATAAGCTA -> GAATAAGCTAT
GAATAAGCTAT -> AATAAGCTATA
AATAAGCTATA -> ATAAGCTATAT
ATAAGCTATAT -> TAAGCTATATA
TAAGCTATATA -> AAGCTATATAC
AAGCTATATAC -> AGCTATATACC
AGCTATATACC -> GCTATATACCA
GCTATATACCA -> CTATATACCAC
CTATATACCAC -> TATATACCACG
TATATACCACG -> ATATACCACGG
ATATACCACGG -> TATACCACGGC
TATACCACGGC -> ATACCACGGCA
ATACCACGGCA -> TACCACGGCAG
TACCACGGCAG -> ACCACGGCAGG
ACCACGGCAGG -> CCACGGCAGGT
CCACGGCAGGT -> CACGGCAGGTG
CACGGCAGGTG -> ACGGCAGGTGT
ACGGCAGGTGT -> CGGCAGGTGTG
CGGCAGGTGTG -> GGCAGGTGTGG
GGCAGGTGTGG -> GCAGGTGTGGA
GCAGGTGTGGA -> CAGGTGTGGAT
CAGGTGTGGAT -> AGGTGTGGATA
AGGTGTGGATA -> GGTGTGGATAC
GGTGTGGATAC -> GTGTGGATACG
GTGTGGATACG -> TGTGGATACGG
TGTGGATACGG -> GTGGATACGGA
GTGGATACGGA -> TGGATACGGAT
TGGATACGGAT -> GGATACGGATG
GGATACGGATG -> GATACGGATGC
GATACGGATGC -> ATACGGATGCG
ATACGGATGCG -> TACGGATGCGT
TACGGATGCGT -> ACGGATGCGTC
ACGGATGCGTC -> CGGATGCGTCC
CGGATGCGTCC -> GGATGCGTCCG
GGATGCGTCCG -> GATGCGTCCGC
GATGCGTCCGC -> ATGCGTCCGCT
ATGCGTCCGCT -> TGCGTCCGCTC
TGCGTCCGCTC -> GCGTCCGCTCG
GCGTCCGCTCG -> CGTCCGCTCGT
CGTCCGCTCGT -> GTCCGCTCGTA
GTCCGCTCGTA -> TCCGCTCGTAT
TCCGCTCGTAT -> CCGCTCGTATT
CCGCTCGTATT -> CGCTCGTATTG
CGCTCGTATTG -> GCTCGTATTGG
GCTCGTATTGG -> CTCGTATTGGA
CTCGTATTGGA -> TCGTATTGGAT
TCGTATTGGAT -> CGTATTGGATA
CGTATTGGATA -> GTATTGGATAC
GTATTGGATAC -> TATTGGATACG
TATTGGATACG -> ATTGGATACGT
ATTGGATACGT -> TTGGATACGTA
TTGGATACGTA -> TGGATACGTAA
TGGATACGTAA -> GGATACGTAAA
GGATACGTAAA -> GATACGTAAAT
GATACGTAAAT -> ATACGTAAATT
ATACGTAAATT -> TACGTAAATTT
TACGTAAATTT -> ACGTAAATTTA
ACGTAAATTTA -> CGTAAATTTAG
CGTAAATTTAG -> GTAAATTTAGC
GTAAATTTAGC -> TAAATTTAGCT
TAAATTTAGCT -> AAATTTAGCTG
AAATTTAGCTG -> AATTTAGCTGG
AATTTAGCTGG -> ATTTAGCTGGT
ATTTAGCTGGT -> TTTAGCTGGTG
TTTAGCTGGTG -> TTAGCTGGTGA
TTAGCTGGTGA -> TAGCTGGTGAG
TAGCTGGTGAG -> AGCTGGTGAGC
AGCTGGTGAGC -> GCTGGTGAGCT
GCTGGTGAGCT -> CTGGTGAGCTA
CTGGTGAGCTA -> TGGTGAGCTAT
TGGTGAGCTAT -> GGTGAGCTATG
GGTGAGCTATG -> GTGAGCTATGA
GTGAGCTATGA -> TGAGCTATGAA
TGAGCTATGAA -> GAGCTATGAAC
GAGCTATGAAC -> AGCTATGAACT
AGCTATGAACT -> GCTATGAACTA
GCTATGAACTA -> CTATGAACTAA
CTATGAACTAA -> TATGAACTAAG
TATGAACTAAG -> ATGAACTAAGG
ATGAACTAAGG -> TGAACTAAGGC
TGAACTAAGGC -> GAACTAAGGCC
GAACTAAGGCC -> AACTAAGGCCC
AACTAAGGCCC -> ACTAAGGCCCG
ACTAAGGCCCG -> CTAAGGCCCGT
CTAAGGCCCGT -> TAAGGCCCGTG
TAAGGCCCGTG -> AAGGCCCGTGA
AAGGCCCGTGA -> AGGCCCGTGAT
AGGCCCGTGAT -> GGCCCGTGATT
GGCCCGTGATT -> GCCCGTGATTG
GCCCGTGATTG -> CCCGTGATTGC
CCCGTGATTGC -> CCGTGATTGCC
CCGTGATTGCC -> CGTGATTGCCG
CGTGATTGCCG -> GTGATTGCCGA
GTGATTGCCGA -> TGATTGCCGAA
TGATTGCCGAA -> GATTGCCGAAG
GATTGCCGAAG -> ATTGCCGAAGG
ATTGCCGAAGG -> TTGCCGAAGGG
TTGCCGAAGGG -> TGCCGAAGGGG
TGCCGAAGGGG -> GCCGAAGGGGA
GCCGAAGGGGA -> CCGAAGGGGAC
CCGAAGGGGAC -> CGAAGGGGACA
CGAAGGGGACA -> GAAGGGGACAC
GAAGGGGACAC -> AAGGGGACACG
AAGGGGACACG -> AGGGGACACGG
AGGGGACACGG -> GGGGACACGGG
GGGGACACGGG -> GGGACACGGGT
GGGACACGGGT -> GGACACGGGTG
GGACACGGGTG -> GACACGGGTGC
GACACGGGTGC -> ACACGGGTGCC
ACACGGGTGCC -> CACGGGTGCCG
CACGGGTGCCG -> ACGGGTGCCGG
ACGGGTGCCGG -> CGGGTGCCGGT
CGGGTGCCGGT -> GGGTGCCGGTG
GGGTGCCGGTG -> GGTGCCGGTGA
GGTGCCGGTGA -> GTGCCGGTGAG
GTGCCGGTGAG -> TGCCGGTGAGT
TGCCGGTGAGT -> GCCGGTGAGTT
GCCGGTGAGTT -> CCGGTGAGTTA
CCGGTGAGTTA -> CGGTGAGTTAA
CGGTGAGTTAA -> GGTGAGTTAAG
GGTGAGTTAAG -> GTGAGTTAAGG
GTGAGTTAAGG -> TGAGTTAAGGT
TGAGTTAAGGT -> GAGTTAAGGTA
GAGTTAAGGTA -> AGTTAAGGTAA
AGTTAAGGTAA -> GTTAAGGTAAA
GTTAAGGTAAA -> TTAAGGTAAAC
TTAAGGTAAAC -> TAAGGTAAACA
TAAGGTAAACA -> AAGGTAAACAG
AAGGTAAACAG -> AGGTAAACAGA
AGGTAAACAGA -> GGTAAACAGAC
GGTAAACAGAC -> GTAAACAGACA
GTAAACAGACA -> TAAACAGACAT
TAAACAGACAT -> AAACAGACATT
AAACAGACATT -> AACAGACATTT
AACAGACATTT -> ACAGACATTTT
ACAGACATTTT -> CAGACATTTTT
CAGACATTTTT -> AGACATTTTTT
AGACATTTTTT -> GACATTTTTTT
GACATTTTTTT -> ACATTTTTTTG
ACATTTTTTTG -> CATTTTTTTGA
CATTTTTTTGA -> ATTTTTTTGAA
ATTTTTTTGAA -> TTTTTTTGAAA
TTTTTTTGAAA -> TTTTTTGAAAA
TTTTTTGAAAA -> TTTTTGAAAAT
TTTTTGAAAAT -> TTTTGAAAATA
TTTTGAAAATA -> TTTGAAAATAC
TTTGAAAATAC -> TTGAAAATACC
TTGAAAATACC -> TGAAAATACCG
TGAAAATACCG -> GAAAATACCGC
GAAAATACCGC -> AAAATACCGCG
AAAATACCGCG -> AAATACCGCGA
AAATACCGCGA -> AATACCGCGAA
AATACCGCGAA -> ATACCGCGAAT
ATACCGCGAAT -> TACCGCGAATC
TACCGCGAATC -> ACCGCGAATCG
ACCGCGAATCG -> CCGCGAATCGA
CCGCGAATCGA -> CGCGAATCGAT
CGCGAATCGAT -> GCGAATCGATC
GCGAATCGATC -> CGAATCGATCG
CGAATCGATCG -> GAATCGATCGA
GAATCGATCGA -> AATCGATCGAG
AATCGATCGAG -> ATCGATCGAGT
ATCGATCGAGT -> TCGATCGAGTG
TCGATCGAGTG -> CGATCGAGTGT
CGATCGAGTGT -> GATCGAGTGTG
GATCGAGTGTG -> ATCGAGTGTGG
ATCGAGTGTGG -> TCGAGTGTGGG
TCGAGTGTGGG -> CGAGTGTGGGC
CGAGTGTGGGC -> GAGTGTGGGCC
GAGTGTGGGCC -> AGTGTGGGCCG
AGTGTGGGCCG -> GTGTGGGCCGT
GTGTGGGCCGT -> TGTGGGCCGTA
TGTGGGCCGTA -> GTGGGCCGTAG
GTGGGCCGTAG -> TGGGCCGTAGG
TGGGCCGTAGG -> GGGCCGTAGGC
GGGCCGTAGGC -> GGCCGTAGGCG
GGCCGTAGGCG -> GCCGTAGGCGA
GCCGTAGGCGA -> CCGTAGGCGAT
CCGTAGGCGAT -> CGTAGGCGATT
CGTAGGCGATT -> GTAGGCGATTG
GTAGGCGATTG -> TAGGCGATTGA
TAGGCGATTGA -> AGGCGATTGAC
AGGCGATTGAC -> GGCGATTGACA
GGCGATTGACA -> GCGATTGACAC
GCGATTGACAC -> CGATTGACACG
CGATTGACACG -> GATTGACACGA
GATTGACACGA -> ATTGACACGAA
ATTGACACGAA -> TTGACACGAAG
TTGACACGAAG -> TGACACGAAGT
TGACACGAAGT -> GACACGAAGTC
GACACGAAGTC -> ACACGAAGTCC
ACACGAAGTCC -> CACGAAGTCCT
CACGAAGTCCT -> ACGAAGTCCTC
ACGAAGTCCTC -> CGAAGTCCTCC
CGAAGTCCTCC -> GAAGTCCTCCC
GAAGTCCTCCC -> AAGTCCTCCCC
AAGTCCTCCCC -> AGTCCTCCCCA
AGTCCTCCCCA -> GTCCTCCCCAG
GTCCTCCCCAG -> TCCTCCCCAGC
TCCTCCCCAGC -> CCTCCCCAGCA
CCTCCCCAGCA -> CTCCCCAGCAC
CTCCCCAGCAC -> TCCCCAGCACC
TCCCCAGCACC -> CCCCAGCACCT
CCCCAGCACCT -> CCCAGCACCTG
CCCAGCACCTG -> CCAGCACCTGT
CCAGCACCTGT -> CAGCACCTGTG
CAGCACCTGTG -> AGCACCTGTGA
AGCACCTGTGA -> GCACCTGTGAC
GCACCTGTGAC -> CACCTGTGACG
CACCTGTGACG -> ACCTGTGACGG
ACCTGTGACGG -> CCTGTGACGGC
CCTGTGACGGC -> CTGTGACGGCT
CTGTGACGGCT -> TGTGACGGCTC
TGTGACGGCTC -> GTGACGGCTCA
GTGACGGCTCA -> TGACGGCTCAA
TGACGGCTCAA -> GACGGCTCAAT
GACGGCTCAAT -> ACGGCTCAATA
ACGGCTCAATA -> CGGCTCAATAG
CGGCTCAATAG -> GGCTCAATAGA
GGCTCAATAGA -> GCTCAATAGAG
GCTCAATAGAG -> CTCAATAGAGA
CTCAATAGAGA -> TCAATAGAGAG
TCAATAGAGAG -> CAATAGAGAGA
CAATAGAGAGA -> AATAGAGAGAA
AATAGAGAGAA -> ATAGAGAGAAA
ATAGAGAGAAA -> TAGAGAGAAAT
TAGAGAGAAAT -> AGAGAGAAATT
AGAGAGAAATT -> GAGAGAAATTC
GAGAGAAATTC -> AGAGAAATTCT
AGAGAAATTCT -> GAGAAATTCTA
GAGAAATTCTA -> AGAAATTCTAA
AGAAATTCTAA -> GAAATTCTAAA
GAAATTCTAAA -> AAATTCTAAAC
AAATTCTAAAC -> AATTCTAAACT
AATTCTAAACT -> ATTCTAAACTC
ATTCTAAACTC -> TTCTAAACTCA
TTCTAAACTCA -> TCTAAACTCAA
TCTAAACTCAA -> CTAAACTCAAC
CTAAACTCAAC -> TAAACTCAACC
TAAACTCAACC -> AAACTCAACCG
AAACTCAACCG -> AACTCAACCGG
AACTCAACCGG -> ACTCAACCGGG
ACTCAACCGGG -> CTCAACCGGGC
CTCAACCGGGC -> TCAACCGGGCC
TCAACCGGGCC -> CAACCGGGCCG
CAACCGGGCCG -> AACCGGGCCGA
AACCGGGCCGA -> ACCGGGCCGAT
ACCGGGCCGAT -> CCGGGCCGATA
CCGGGCCGATA -> CGGGCCGATAC
CGGGCCGATAC -> GGGCCGATACG
GGGCCGATACG -> GGCCGATACGC
GGCCGATACGC -> GCCGATACGCA
GCCGATACGCA -> CCGATACGCAC
CCGATACGCAC -> CGATACGCACA
CGATACGCACA -> GATACGCACAA
GATACGCACAA -> ATACGCACAAT
ATACGCACAAT -> TACGCACAATT
TACGCACAATT -> ACGCACAATTA
ACGCACAATTA -> CGCACAATTAC
CGCACAATTAC -> GCACAATTACC
GCACAATTACC -> CACAATTACCA
CACAATTACCA -> ACAATTACCAC
ACAATTACCAC -> CAATTACCACC
CAATTACCACC -> AATTACCACCA
AATTACCACCA -> ATTACCACCAA
ATTACCACCAA -> TTACCACCAAT
TTACCACCAAT -> TACCACCAATT
TACCACCAATT -> ACCACCAATTG
ACCACCAATTG -> CCACCAATTGC
CCACCAATTGC -> CACCAATTGCA
CACCAATTGCA -> ACCAATTGCAA
ACCAATTGCAA -> CCAATTGCAAA
CCAATTGCAAA -> CAATTGCAAAA
CAATTGCAAAA -> AATTGCAAAAT
AATTGCAAAAT -> ATTGCAAAATA
ATTGCAAAATA -> TTGCAAAATAT
TTGCAAAATAT -> TGCAAAATATT
TGCAAAATATT -> GCAAAATATTA
GCAAAATATTA -> CAAAATATTAG
CAAAATATTAG -> AAAATATTAGT
AAAATATTAGT -> AAATATTAGTC
AAATATTAGTC -> AATATTAGTCA
AATATTAGTCA -> ATATTAGTCAG
ATATTAGTCAG -> TATTAGTCAGG
TATTAGTCAGG -> ATTAGTCAGGA
ATTAGTCAGGA -> TTAGTCAGGAC
TTAGTCAGGAC -> TAGTCAGGACA
TAGTCAGGACA -> AGTCAGGACAA
AGTCAGGACAA -> GTCAGGACAAA
GTCAGGACAAA -> TCAGGACAAAG
TCAGGACAAAG -> CAGGACAAAGA
CAGGACAAAGA -> AGGACAAAGAA
AGGACAAAGAA -> GGACAAAGAAG
GGACAAAGAAG -> GACAAAGAAGA
GACAAAGAAGA -> ACAAAGAAGAT
ACAAAGAAGAT -> CAAAGAAGATC
CAAAGAAGATC -> AAAGAAGATCT
AAAGAAGATCT -> AAGAAGATCTA
AAGAAGATCTA -> AGAAGATCTAT
AGAAGATCTAT -> GAAGATCTATC
GAAGATCTATC -> AAGATCTATCC
AAGATCTATCC -> AGATCTATCCT
AGATCTATCCT -> GATCTATCCTT
GATCTATCCTT -> ATCTATCCTTA
ATCTATCCTTA -> TCTATCCTTAC
TCTATCCTTAC -> CTATCCTTACG
CTATCCTTACG -> TATCCTTACGC
TATCCTTACGC -> ATCCTTACGCC
ATCCTTACGCC -> TCCTTACGCCT
TCCTTACGCCT -> CCTTACGCCTA
CCTTACGCCTA -> CTTACGCCTAA
CTTACGCCTAA -> TTACGCCTAAC
TTACGCCTAAC -> TACGCCTAACC
TACGCCTAACC -> ACGCCTAACCT
ACGCCTAACCT -> CGCCTAACCTA
CGCCTAACCTA -> GCCTAACCTAT
GCCTAACCTAT -> CCTAACCTATT
CCTAACCTATT -> CTAACCTATTG
CTAACCTATTG -> TAACCTATTGG
TAACCTATTGG -> AACCTATTGGA
AACCTATTGGA -> ACCTATTGGAG
ACCTATTGGAG -> CCTATTGGAGT
CCTATTGGAGT -> CTATTGGAGTC
CTATTGGAGTC -> TATTGGAGTCA
TATTGGAGTCA -> ATTGGAGTCAC
ATTGGAGTCAC -> TTGGAGTCACA
TTGGAGTCACA -> TGGAGTCACAC
TGGAGTCACAC -> GGAGTCACACT
GGAGTCACACT -> GAGTCACACTG
GAGTCACACTG -> AGTCACACTGT
AGTCACACTGT -> GTCACACTGTT
GTCACACTGTT -> TCACACTGTTA
TCACACTGTTA -> CACACTGTTAG
CACACTGTTAG -> ACACTGTTAGT
ACACTGTTAGT -> CACTGTTAGTA
CACTGTTAGTA -> ACTGTTAGTAA
ACTGTTAGTAA -> CTGTTAGTAAA
CTGTTAGTAAA -> TGTTAGTAAAA,TGTTAGTAAAT
TGTTAGTAAAA -> GTTAGTAAAAA
GTTAGTAAAAA -> TTAGTAAAAAA
TTAGTAAAAAA -> TAGTAAAAAAC
TAGTAAAAAAC -> AGTAAAAAACA
AGTAAAAAACA -> GTAAAAAACAA
GTAAAAAACAA -> TAAAAAACAAC
TAAAAAACAAC -> AAAAAACAACG
AAAAAACAACG -> AAAAACAACGC
AAAAACAACGC -> AAAACAACGCA
AAAACAACGCA -> AAACAACGCAC
AAACAACGCAC -> AACAACGCACA
AACAACGCACA -> ACAACGCACAA
ACAACGCACAA -> CAACGCACAAA
CAACGCACAAA -> AACGCACAAAG
AACGCACAAAG -> ACGCACAAAGG
ACGCACAAAGG -> CGCACAAAGGT
CGCACAAAGGT -> GCACAAAGGTA
GCACAAAGGTA -> CACAAAGGTAT
CACAAAGGTAT -> ACAAAGGTATG
ACAAAGGTATG -> CAAAGGTATGT
CAAAGGTATGT -> AAAGGTATGTG
AAAGGTATGTG -> AAGGTATGTGT
AAGGTATGTGT -> AGGTATGTGTC
AGGTATGTGTC -> GGTATGTGTCA
GGTATGTGTCA -> GTATGTGTCAT
GTATGTGTCAT -> TATGTGTCATA
TATGTGTCATA -> ATGTGTCATAT
ATGTGTCATAT -> TGTGTCATATA
TGTGTCATATA -> GTGTCATATAG
GTGTCATATAG -> TGTCATATAGT
TGTCATATAGT -> GTCATATAGTA
GTCATATAGTA -> TCATATAGTAT
TCATATAGTAT -> CATATAGTATT
CATATAGTATT -> ATATAGTATTA
ATATAGTATTA -> TATAGTATTAT
TATAGTATTAT -> ATAGTATTATG
ATAGTATTATG -> TAGTATTATGA
TAGTATTATGA -> AGTATTATGAG
AGTATTATGAG -> GTATTATGAGT
GTATTATGAGT -> TATTATGAGTC
TATTATGAGTC -> ATTATGAGTCT
ATTATGAGTCT -> TTATGAGTCTG
TTATGAGTCTG -> TATGAGTCTGA
TATGAGTCTGA -> ATGAGTCTGAA
ATGAGTCTGAA -> TGAGTCTGAAA
TGAGTCTGAAA -> GAGTCTGAAAC
GAGTCTGAAAC -> AGTCTGAAACA
AGTCTGAAACA -> GTCTGAAACAT
GTCTGAAACAT -> TCTGAAACATG
TCTGAAACATG -> CTGAAACATGC
CTGAAACATGC -> TGAAACATGCA
TGAAACATGCA -> GAAACATGCAG
GAAACATGCAG -> AAACATGCAGC
AAACATGCAGC -> AACATGCAGCA
AACATGCAGCA -> ACATGCAGCAT
ACATGCAGCAT -> CATGCAGCATG
CATGCAGCATG -> ATGCAGCATGG
ATGCAGCATGG -> TGCAGCATGGA
TGCAGCATGGA -> GCAGCATGGAT
GCAGCATGGAT -> CAGCATGGATT
CAGCATGGATT -> AGCATGGATTC
AGCATGGATTC -> GCATGGATTCC
GCATGGATTCC -> CATGGATTCCG
CATGGATTCCG -> ATGGATTCCGA
ATGGATTCCGA -> TGGATTCCGAG
TGGATTCCGAG -> GGATTCCGAGA
GGATTCCGAGA -> GATTCCGAGAC
GATTCCGAGAC -> ATTCCGAGACC
ATTCCGAGACC -> TTCCGAGACCA
TTCCGAGACCA -> TCCGAGACCAT
TCCGAGACCAT -> CCGAGACCATG
CCGAGACCATG -> CGAGACCATGC
CGAGACCATGC -> GAGACCATGCA
GAGACCATGCA -> AGACCATGCAA
AGACCATGCAA -> GACCATGCAAC
GACCATGCAAC -> ACCATGCAACC
ACCATGCAACC -> CCATGCAACCC
CCATGCAACCC -> CATGCAACCCT
CATGCAACCCT -> ATGCAACCCTG
ATGCAACCCTG -> TGCAACCCTGA
TGCAACCCTGA -> GCAACCCTGAG
GCAACCCTGAG -> CAACCCTGAGC
CAACCCTGAGC -> AACCCTGAGCT
AACCCTGAGCT -> ACCCTGAGCTG
ACCCTGAGCTG -> CCCTGAGCTGC
CCCTGAGCTGC -> CCTGAGCTGCT
CCTGAGCTGCT -> CTGAGCTGCTC
CTGAGCTGCTC -> TGAGCTGCTCT
TGAGCTGCTCT -> GAGCTGCTCTG
GAGCTGCTCTG -> AGCTGCTCTGT
AGCTGCTCTGT -> GCTGCTCTGTA
GCTGCTCTGTA -> CTGCTCTGTAA
CTGCTCTGTAA -> TGCTCTGTAAA
TGCTCTGTAAA -> GCTCTGTAAAG
GCTCTGTAAAG -> CTCTGTAAAGG
CTCTGTAAAGG -> TCTGTAAAGGA
TCTGTAAAGGA -> CTGTAAAGGAT
CTGTAAAGGAT -> TGTAAAGGATC
TGTAAAGGATC -> GTAAAGGATCG
GTAAAGGATCG -> TAAAGGATCGT
TAAAGGATCGT -> AAAGGATCGTA
AAAGGATCGTA -> AAGGATCGTAG
AAGGATCGTAG -> AGGATCGTAGC
AGGATCGTAGC -> GGATCGTAGCA
GGATCGTAGCA -> GATCGTAGCAT
GATCGTAGCAT -> ATCGTAGCATC
ATCGTAGCATC -> TCGTAGCATCG
TCGTAGCATCG -> CGTAGCATCGG
CGTAGCATCGG -> GTAGCATCGGT
GTAGCATCGGT -> TAGCATCGGTC
TAGCATCGGTC -> AGCATCGGTCT
AGCATCGGTCT -> GCATCGGTCTA
GCATCGGTCTA -> CATCGGTCTAC
CATCGGTCTAC -> ATCGGTCTACA
ATCGGTCTACA -> TCGGTCTACAA
TCGGTCTACAA -> CGGTCTACAAG
CGGTCTACAAG -> GGTCTACAAGC
GGTCTACAAGC -> GTCTACAAGCC
GTCTACAAGCC -> TCTACAAGCCA
TCTACAAGCCA -> CTACAAGCCAG
CTACAAGCCAG -> TACAAGCCAGT
TACAAGCCAGT -> ACAAGCCAGTG
ACAAGCCAGTG -> CAAGCCAGTGA
CAAGCCAGTGA -> AAGCCAGTGAG
AAGCCAGTGAG -> AGCCAGTGAGC
AGCCAGTGAGC -> GCCAGTGAGCT
GCCAGTGAGCT -> CCAGTGAGCTG
CCAGTGAGCTG -> CAGTGAGCTGA
CAGTGAGCTGA -> AGTGAGCTGAC
AGTGAGCTGAC -> GTGAGCTGACC
GTGAGCTGACC -> TGAGCTGACCA
TGAGCTGACCA -> GAGCTGACCAC
GAGCTGACCAC -> AGCTGACCACT
AGCTGACCACT -> GCTGACCACTA
GCTGACCACTA -> CTGACCACTAC
CTGACCACTAC -> TGACCACTACA
TGACCACTACA -> GACCACTACAG
GACCACTACAG -> ACCACTACAGT
ACCACTACAGT -> CCACTACAGTG
CCACTACAGTG -> CACTACAGTGT
CACTACAGTGT -> ACTACAGTGTG
ACTACAGTGTG -> CTACAGTGTGT
CTACAGTGTGT -> TACAGTGTGTC
TACAGTGTGTC -> ACAGTGTGTCC
ACAGTGTGTCC -> CAGTGTGTCCC
CAGTGTGTCCC -> AGTGTGTCCCC
AGTGTGTCCCC -> GTGTGTCCCCC
GTGTGTCCCCC -> TGTGTCCCCCC
TGTGTCCCCCC -> GTGTCCCCCCC
GTGTCCCCCCC -> TGTCCCCCCCC
TGTCCCCCCCC -> GTCCCCCCCCC
GTCCCCCCCCC -> TCCCCCCCCCG
TCCCCCCCCCG -> CCCCCCCCCGG
CCCCCCCCCGG -> CCCCCCCCGGG
CCCCCCCCGGG -> CCCCCCCGGGC
CCCCCCCGGGC -> CCCCCCGGGCG
CCCCCCGGGCG -> CCCCCGGGCGC
CCCCCGGGCGC -> CCCCGGGCGCT
CCCCGGGCGCT -> CCCGGGCGCTG
CCCGGGCGCTG -> CCGGGCGCTGT
CCGGGCGCTGT -> CGGGCGCTGTT
CGGGCGCTGTT -> GGGCGCTGTTA
GGGCGCTGTTA -> GGCGCTGTTAG
GGCGCTGTTAG -> GCGCTGTTAGT
GCGCTGTTAGT -> CGCTGTTAGTA
CGCTGTTAGTA -> GCTGTTAGTAA
GCTGTTAGTAA -> CTGTTAGTAAA
TGTTAGTAAAT -> GTTAGTAAATC
GTTAGTAAATC -> TTAGTAAATCC
TTAGTAAATCC -> TAGTAAATCCA
TAGTAAATCCA -> AGTAAATCCAC
AGTAAATCCAC -> GTAAATCCACT
GTAAATCCACT -> TAAATCCACTA
TAAATCCACTA -> AAATCCACTAA
AAATCCACTAA -> AATCCACTAAT
AATCCACTAAT -> ATCCACTAATT
ATCCACTAATT -> TCCACTAATTT
TCCACTAATTT -> CCACTAATTTA
CCACTAATTTA -> CACTAATTTAG
CACTAATTTAG -> ACTAATTTAGT
ACTAATTTAGT -> CTAATTTAGTC
CTAATTTAGTC -> TAATTTAGTCA
TAATTTAGTCA -> AATTTAGTCAT
AATTTAGTCAT -> ATTTAGTCATG
ATTTAGTCATG -> TTTAGTCATGG
TTTAGTCATGG -> TTAGTCATGGA
TTAGTCATGGA -> TAGTCATGGAC
TAGTCATGGAC -> AGTCATGGACT
AGTCATGGACT -> GTCATGGACTA
GTCATGGACTA -> TCATGGACTAT
TCATGGACTAT -> CATGGACTATG
CATGGACTATG -> ATGGACTATGC
ATGGACTATGC -> TGGACTATGCT
TGGACTATGCT -> GGACTATGCTG
GGACTATGCTG -> GACTATGCTGT
GACTATGCTGT -> ACTATGCTGTG
ACTATGCTGTG -> CTATGCTGTGA
CTATGCTGTGA -> TATGCTGTGAT
TATGCTGTGAT -> ATGCTGTGATT
ATGCTGTGATT -> TGCTGTGATTA
TGCTGTGATTA -> GCTGTGATTAA
GCTGTGATTAA -> CTGTGATTAAC
CTGTGATTAAC -> TGTGATTAACA
TGTGATTAACA -> GTGATTAACAG
GTGATTAACAG -> TGATTAACAGC
TGATTAACAGC -> GATTAACAGCC
GATTAACAGCC -> ATTAACAGCCG
ATTAACAGCCG -> TTAACAGCCGC
TTAACAGCCGC -> TAACAGCCGCT
TAACAGCCGCT -> AACAGCCGCTT
AACAGCCGCTT -> ACAGCCGCTTT
ACAGCCGCTTT -> CAGCCGCTTTG
CAGCCGCTTTG -> AGCCGCTTTGC
AGCCGCTTTGC -> GCCGCTTTGCT
GCCGCTTTGCT -> CCGCTTTGCTG
CCGCTTTGCTG -> CGCTTTGCTGA
CGCTTTGCTGA -> GCTTTGCTGAG
GCTTTGCTGAG -> CTTTGCTGAGC
CTTTGCTGAGC -> TTTGCTGAGCA
TTTGCTGAGCA -> TTGCTGAGCAT
TTGCTGAGCAT -> TGCTGAGCATG
TGCTGAGCATG -> GCTGAGCATGA
GCTGAGCATGA -> CTGAGCATGAA
CTGAGCATGAA -> TGAGCATGAAG
TGAGCATGAAG -> GAGCATGAAGA
GAGCATGAAGA -> AGCATGAAGAA
AGCATGAAGAA -> GCATGAAGAAG
GCATGAAGAAG -> CATGAAGAAGC
CATGAAGAAGC -> ATGAAGAAGCG
ATGAAGAAGCG -> TGAAGAAGCGG
TGAAGAAGCGG -> GAAGAAGCGGG
GAAGAAGCGGG -> AAGAAGCGGGG
AAGAAGCGGGG -> AGAAGCGGGGC
AGAAGCGGGGC -> GAAGCGGGGCT
GAAGCGGGGCT -> AAGCGGGGCTC
AAGCGGGGCTC -> AGCGGGGCTCT
AGCGGGGCTCT -> GCGGGGCTCTA
GCGGGGCTCTA -> CGGGGCTCTAC
CGGGGCTCTAC -> GGGGCTCTACC
GGGGCTCTACC -> GGGCTCTACCA
GGGCTCTACCA -> GGCTCTACCAC
GGCTCTACCAC -> GCTCTACCACG
GCTCTACCACG -> CTCTACCACGC
CTCTACCACGC -> TCTACCACGCC
TCTACCACGCC -> CTACCACGCCT
CTACCACGCCT -> TACCACGCCTC
TACCACGCCTC -> ACCACGCCTCC
ACCACGCCTCC -> CCACGCCTCCC
CCACGCCTCCC -> CACGCCTCCCG
CACGCCTCCCG -> ACGCCTCCCGA
ACGCCTCCCGA -> CGCCTCCCGAA
CGCCTCCCGAA -> GCCTCCCGAAG
GCCTCCCGAAG -> CCTCCCGAAGG
CCTCCCGAAGG -> CTCCCGAAGGG
CTCCCGAAGGG -> TCCCGAAGGGA
TCCCGAAGGGA -> CCCGAAGGGAG
CCCGAAGGGAG -> CCGAAGGGAGC
CCGAAGGGAGC -> CGAAGGGAGCG
CGAAGGGAGCG -> GAAGGGAGCGA
GAAGGGAGCGA -> AAGGGAGCGAA
AAGGGAGCGAA -> AGGGAGCGAAT
AGGGAGCGAAT -> GGGAGCGAATT
GGGAGCGAATT -> GGAGCGAATTG
GGAGCGAATTG -> GAGCGAATTGA
GAGCGAATTGA -> AGCGAATTGAG
AGCGAATTGAG -> GCGAATTGAGT
GCGAATTGAGT -> CGAATTGAGTA
CGAATTGAGTA -> GAATTGAGTAT
GAATTGAGTAT -> AATTGAGTATG
AATTGAGTATG -> ATTGAGTATGC
ATTGAGTATGC -> TTGAGTATGCA
TTGAGTATGCA -> TGAGTATGCAT
TGAGTATGCAT -> GAGTATGCATG
GAGTATGCATG -> AGTATGCATGA
AGTATGCATGA -> GTATGCATGAC
GTATGCATGAC -> TATGCATGACC
TATGCATGACC -> ATGCATGACCC
ATGCATGACCC -> TGCATGACCCC
TGCATGACCCC -> GCATGACCCCT
GCATGACCCCT -> CATGACCCCTG
CATGACCCCTG -> ATGACCCCTGT
ATGACCCCTGT -> TGACCCCTGTG
TGACCCCTGTG -> GACCCCTGTGT
GACCCCTGTGT -> ACCCCTGTGTT
ACCCCTGTGTT -> CCCCTGTGTTG
CCCCTGTGTTG -> CCCTGTGTTGG
CCCTGTGTTGG -> CCTGTGTTGGC
CCTGTGTTGGC -> CTGTGTTGGCA
CTGTGTTGGCA -> TGTGTTGGCAG
TGTGTTGGCAG -> GTGTTGGCAGT
GTGTTGGCAGT -> TGTTGGCAGTC
TGTTGGCAGTC -> GTTGGCAGTCC
GTTGGCAGTCC -> TTGGCAGTCCT
TTGGCAGTCCT -> TGGCAGTCCTA
TGGCAGTCCTA -> GGCAGTCCTAA
GGCAGTCCTAA -> GCAGTCCTAAA
GCAGTCCTAAA -> CAGTCCTAAAC
CAGTCCTAAAC -> AGTCCTAAACC
AGTCCTAAACC -> GTCCTAAACCC
GTCCTAAACCC -> TCCTAAACCCG
TCCTAAACCCG -> CCTAAACCCGG
CCTAAACCCGG -> CTAAACCCGGG
CTAAACCCGGG -> TAAACCCGGGG
TAAACCCGGGG -> AAACCCGGGGT
AAACCCGGGGT -> AACCCGGGGTG
AACCCGGGGTG -> ACCCGGGGTGC
ACCCGGGGTGC -> CCCGGGGTGCG
CCCGGGGTGCG -> CCGGGGTGCGT
CCGGGGTGCGT -> CGGGGTGCGTC
CGGGGTGCGTC -> GGGGTGCGTCA
GGGGTGCGTCA -> GGGTGCGTCAT
GGGTGCGTCAT -> GGTGCGTCATC
GGTGCGTCATC -> GTGCGTCATCC
GTGCGTCATCC -> TGCGTCATCCG
TGCGTCATCCG -> GCGTCATCCGA
GCGTCATCCGA -> CGTCATCCGAA
CGTCATCCGAA -> GTCATCCGAAA
GTCATCCGAAA -> TCATCCGAAAG
TCATCCGAAAG -> CATCCGAAAGG
CATCCGAAAGG -> ATCCGAAAGGA
ATCCGAAAGGA -> TCCGAAAGGAC
TCCGAAAGGAC -> CCGAAAGGACG
CCGAAAGGACG -> CGAAAGGACGG
CGAAAGGACGG -> GAAAGGACGGT
GAAAGGACGGT -> AAAGGACGGTC
AAAGGACGGTC -> AAGGACGGTCC
AAGGACGGTCC -> AGGACGGTCCC
AGGACGGTCCC -> GGACGGTCCCA
GGACGGTCCCA -> GACGGTCCCAG
GACGGTCCCAG -> ACGGTCCCAGA
ACGGTCCCAGA -> CGGTCCCAGAC
CGGTCCCAGAC -> GGTCCCAGACG
GGTCCCAGACG -> GTCCCAGACGC
GTCCCAGACGC -> TCCCAGACGCA
TCCCAGACGCA -> CCCAGACGCAC
CCCAGACGCAC -> CCAGACGCACT
CCAGACGCACT -> CAGACGCACTA
CAGACGCACTA -> AGACGCACTAG
AGACGCACTAG -> GACGCACTAGT
GACGCACTAGT -> ACGCACTAGTA
ACGCACTAGTA -> CGCACTAGTAG
CGCACTAGTAG -> GCACTAGTAGG
GCACTAGTAGG -> CACTAGTAGGC
CACTAGTAGGC -> ACTAGTAGGCC
ACTAGTAGGCC -> CTAGTAGGCCT
CTAGTAGGCCT -> TAGTAGGCCTA
TAGTAGGCCTA -> AGTAGGCCTAC
AGTAGGCCTAC -> GTAGGCCTACG
GTAGGCCTACG -> TAGGCCTACGC
TAGGCCTACGC -> AGGCCTACGCC
AGGCCTACGCC -> GGCCTACGCCA
GGCCTACGCCA -> GCCTACGCCAC
GCCTACGCCAC -> CCTACGCCACA
CCTACGCCACA -> CTACGCCACAA
CTACGCCACAA -> TACGCCACAAG
TACGCCACAAG -> ACGCCACAAGC
ACGCCACAAGC -> CGCCACAAGCT
CGCCACAAGCT -> GCCACAAGCTC
GCCACAAGCTC -> CCACAAGCTCT
CCACAAGCTCT -> CACAAGCTCTG
CACAAGCTCTG -> ACAAGCTCTGC
ACAAGCTCTGC -> CAAGCTCTGCT
CAAGCTCTGCT -> AAGCTCTGCTG
AAGCTCTGCTG -> AGCTCTGCTGC
AGCTCTGCTGC -> GCTCTGCTGCG
GCTCTGCTGCG -> CTCTGCTGCGT
CTCTGCTGCGT -> TCTGCTGCGTA
TCTGCTGCGTA -> CTGCTGCGTAA
CTGCTGCGTAA -> TGCTGCGTAAT
TGCTGCGTAAT -> GCTGCGTAATA
GCTGCGTAATA -> CTGCGTAATAG
CTGCGTAATAG -> TGCGTAATAGC
TGCGTAATAGC -> GCGTAATAGCT
GCGTAATAGCT -> CGTAATAGCTT
CGTAATAGCTT -> GTAATAGCTTT
GTAATAGCTTT -> TAATAGCTTTC
TAATAGCTTTC -> AATAGCTTTCT
AATAGCTTTCT -> ATAGCTTTCTT
ATAGCTTTCTT -> TAGCTTTCTTA
TAGCTTTCTTA -> AGCTTTCTTAT
AGCTTTCTTAT -> GCTTTCTTATG
GCTTTCTTATG -> CTTTCTTATGG
CTTTCTTATGG -> TTTCTTATGGA
TTTCTTATGGA -> TTCTTATGGAC
TTCTTATGGAC -> TCTTATGGACA
TCTTATGGACA -> CTTATGGACAA
CTTATGGACAA -> TTATGGACAAT
TTATGGACAAT -> TATGGACAATC
TATGGACAATC -> ATGGACAATCG
ATGGACAATCG -> TGGACAATCGC
TGGACAATCGC -> GGACAATCGCG
GGACAATCGCG -> GACAATCGCGG
GACAATCGCGG -> ACAATCGCGGG
ACAATCGCGGG -> CAATCGCGGGT
CAATCGCGGGT -> AATCGCGGGTG
AATCGCGGGTG -> ATCGCGGGTGT
ATCGCGGGTGT -> TCGCGGGTGTA
TCGCGGGTGTA -> CGCGGGTGTAG
CGCGGGTGTAG -> GCGGGTGTAGG
GCGGGTGTAGG -> CGGGTGTAGGA
CGGGTGTAGGA -> GGGTGTAGGAC
GGGTGTAGGAC -> GGTGTAGGACG
GGTGTAGGACG -> GTGTAGGACGT
GTGTAGGACGT -> TGTAGGACGTG
TGTAGGACGTG -> GTAGGACGTGT
GTAGGACGTGT -> TAGGACGTGTA
TAGGACGTGTA -> AGGACGTGTAC
AGGACGTGTAC -> GGACGTGTACA
GGACGTGTACA -> GACGTGTACAC
GACGTGTACAC -> ACGTGTACACT
ACGTGTACACT -> CGTGTACACTG
CGTGTACACTG -> GTGTACACTGA
GTGTACACTGA -> TGTACACTGAT
TGTACACTGAT -> GTACACTGATA
GTACACTGATA -> TACACTGATAG
TACACTGATAG -> ACACTGATAGA
ACACTGATAGA -> CACTGATAGAC
CACTGATAGAC -> ACTGATAGACA
ACTGATAGACA -> CTGATAGACAA
CTGATAGACAA -> TGATAGACAAG
TGATAGACAAG -> GATAGACAAGA
GATAGACAAGA -> ATAGACAAGAG
ATAGACAAGAG -> TAGACAAGAGA
TAGACAAGAGA -> AGACAAGAGAC
AGACAAGAGAC -> GACAAGAGACT
GACAAGAGACT -> ACAAGAGACTA
ACAAGAGACTA -> CAAGAGACTAC
CAAGAGACTAC -> AAGAGACTACT
AAGAGACTACT -> AGAGACTACTG
AGAGACTACTG -> GAGACTACTGT
GAGACTACTGT -> AGACTACTGTC
AGACTACTGTC -> GACTACTGTCG
GACTACTGTCG -> ACTACTGTCGA
ACTACTGTCGA -> CTACTGTCGAA
CTACTGTCGAA -> TACTGTCGAAG
TACTGTCGAAG -> ACTGTCGAAGC
ACTGTCGAAGC -> CTGTCGAAGCT
CTGTCGAAGCT -> TGTCGAAGCTG
TGTCGAAGCTG -> GTCGAAGCTGC
GTCGAAGCTGC -> TCGAAGCTGCC
TCGAAGCTGCC -> CGAAGCTGCCC
CGAAGCTGCCC -> GAAGCTGCCCG
GAAGCTGCCCG -> AAGCTGCCCGA
AAGCTGCCCGA -> AGCTGCCCGAA
AGCTGCCCGAA -> GCTGCCCGAAT
GCTGCCCGAAT -> CTGCCCGAATT
CTGCCCGAATT -> TGCCCGAATTC
TGCCCGAATTC -> GCCCGAATTCT
GCCCGAATTCT -> CCCGAATTCTC
CCCGAATTCTC -> CCGAATTCTCG
CCGAATTCTCG -> CGAATTCTCGA
CGAATTCTCGA -> GAATTCTCGAG
GAATTCTCGAG -> AATTCTCGAGA
AATTCTCGAGA -> ATTCTCGAGAC
ATTCTCGAGAC -> TTCTCGAGACC
TTCTCGAGACC -> TCTCGAGACCC
TCTCGAGACCC -> CTCGAGACCCG
CTCGAGACCCG -> TCGAGACCCGG
TCGAGACCCGG -> CGAGACCCGGG
CGAGACCCGGG -> GAGACCCGGGA
GAGACCCGGGA -> AGACCCGGGAG
AGACCCGGGAG -> GACCCGGGAGA
GACCCGGGAGA -> ACCCGGGAGAG
ACCCGGGAGAG -> CCCGGGAGAGA
CCCGGGAGAGA -> CCGGGAGAGAA
CCGGGAGAGAA -> CGGGAGAGAAT
CGGGAGAGAAT -> GGGAGAGAATT
GGGAGAGAATT -> GGAGAGAATTT
GGAGAGAATTT -> GAGAGAATTTT
GAGAGAATTTT -> AGAGAATTTTA
AGAGAATTTTA -> GAGAATTTTAT
GAGAATTTTAT -> AGAATTTTATA
AGAATTTTATA -> GAATTTTATAC
GAATTTTATAC -> AATTTTATACC
AATTTTATACC -> ATTTTATACCG
ATTTTATACCG -> TTTTATACCGA
TTTTATACCGA -> TTTATACCGAA
TTTATACCGAA -> TTATACCGAAC
TTATACCGAAC -> TATACCGAACA
TATACCGAACA -> ATACCGAACAC
ATACCGAACAC -> TACCGAACACA
TACCGAACACA -> ACCGAACACAG
ACCGAACACAG -> CCGAACACAGC
CCGAACACAGC -> CGAACACAGCC
CGAACACAGCC -> GAACACAGCCG
GAACACAGCCG -> AACACAGCCGT
AACACAGCCGT -> ACACAGCCGTC
ACACAGCCGTC -> CACAGCCGTCC
CACAGCCGTCC -> ACAGCCGTCCT
ACAGCCGTCCT -> CAGCCGTCCTG
CAGCCGTCCTG -> AGCCGTCCTGT
AGCCGTCCTGT -> GCCGTCCTGTT
GCCGTCCTGTT -> CCGTCCTGTTC
CCGTCCTGTTC -> CGTCCTGTTCC
CGTCCTGTTCC -> GTCCTGTTCCT
GTCCTGTTCCT -> TCCTGTTCCTA
TCCTGTTCCTA -> CCTGTTCCTAA
CCTGTTCCTAA -> CTGTTCCTAAG
CTGTTCCTAAG -> TGTTCCTAAGC
TGTTCCTAAGC -> GTTCCTAAGCC
GTTCCTAAGCC -> TTCCTAAGCCC
TTCCTAAGCCC -> TCCTAAGCCCG
TCCTAAGCCCG -> CCTAAGCCCGT
CCTAAGCCCGT -> CTAAGCCCGTA
CTAAGCCCGTA -> TAAGCCCGTAT
TAAGCCCGTAT -> AAGCCCGTATT
AAGCCCGTATT -> AGCCCGTATTT
AGCCCGTATTT -> GCCCGTATTTG
GCCCGTATTTG -> CCCGTATTTGT
CCCGTATTTGT -> CCGTATTTGTG
CCGTATTTGTG -> CGTATTTGTGT
CGTATTTGTGT -> GTATTTGTGTG
GTATTTGTGTG -> TATTTGTGTGC
TATTTGTGTGC -> ATTTGTGTGCG
ATTTGTGTGCG -> TTTGTGTGCGG
TTTGTGTGCGG -> TTGTGTGCGGA
TTGTGTGCGGA -> TGTGTGCGGAA
TGTGTGCGGAA -> GTGTGCGGAAG
GTGTGCGGAAG -> TGTGCGGAAGA
TGTGCGGAAGA -> GTGCGGAAGAG
GTGCGGAAGAG -> TGCGGAAGAGT
TGCGGAAGAGT -> GCGGAAGAGTA
GCGGAAGAGTA -> CGGAAGAGTAC
CGGAAGAGTAC -> GGAAGAGTACG
GGAAGAGTACG -> GAAGAGTACGT
GAAGAGTACGT -> AAGAGTACGTT
AAGAGTACGTT -> AGAGTACGTTT
AGAGTACGTTT -> GAGTACGTTTG
GAGTACGTTTG -> AGTACGTTTGC
AGTACGTTTGC -> GTACGTTTGCA
GTACGTTTGCA -> TACGTTTGCAC
TACGTTTGCAC -> ACGTTTGCACG
ACGTTTGCACG -> CGTTTGCACGT
CGTTTGCACGT -> GTTTGCACGTA
GTTTGCACGTA -> TTTGCACGTAT
TTTGCACGTAT -> TTGCACGTATC
TTGCACGTATC -> TGCACGTATCC
TGCACGTATCC -> GCACGTATCCC
GCACGTATCCC -> CACGTATCCCG
CACGTATCCCG -> ACGTATCCCGC
ACGTATCCCGC -> CGTATCCCGCA
CGTATCCCGCA -> GTATCCCGCAC
GTATCCCGCAC -> TATCCCGCACA
TATCCCGCACA -> ATCCCGCACAT
ATCCCGCACAT -> TCCCGCACATG
TCCCGCACATG -> CCCGCACATGA
CCCGCACATGA -> CCGCACATGAA
CCGCACATGAA -> CGCACATGAAG
CGCACATGAAG -> GCACATGAAGG
GCACATGAAGG -> CACATGAAGGT
CACATGAAGGT -> ACATGAAGGTC
ACATGAAGGTC -> CATGAAGGTCT
CATGAAGGTCT -> ATGAAGGTCTG
ATGAAGGTCTG -> TGAAGGTCTGA
TGAAGGTCTGA -> GAAGGTCTGAT
GAAGGTCTGAT -> AAGGTCTGATA
AAGGTCTGATA -> AGGTCTGATAA
AGGTCTGATAA -> GGTCTGATAAA
GGTCTGATAAA -> GTCTGATAAAT
GTCTGATAAAT -> TCTGATAAATG
TCTGATAAATG -> CTGATAAATGA
CTGATAAATGA -> TGATAAATGAG
TGATAAATGAG -> GATAAATGAGA
GATAAATGAGA -> ATAAATGAGAG
ATAAATGAGAG -> TAAATGAGAGG
TAAATGAGAGG -> AAATGAGAGGA
AAATGAGAGGA -> AATGAGAGGAT
AATGAGAGGAT -> ATGAGAGGATG
ATGAGAGGATG -> TGAGAGGATGG
TGAGAGGATGG -> GAGAGGATGGT
GAGAGGATGGT -> AGAGGATGGTG
AGAGGATGGTG -> GAGGATGGTGG
GAGGATGGTGG -> AGGATGGTGGT
AGGATGGTGGT -> GGATGGTGGTC
GGATGGTGGTC -> GATGGTGGTCC
GATGGTGGTCC -> ATGGTGGTCCC
ATGGTGGTCCC -> TGGTGGTCCCC
TGGTGGTCCCC -> GGTGGTCCCCA
GGTGGTCCCCA -> GTGGTCCCCAA
GTGGTCCCCAA -> TGGTCCCCAAT
TGGTCCCCAAT -> GGTCCCCAATC
GGTCCCCAATC -> GTCCCCAATCC
GTCCCCAATCC -> TCCCCAATCCA
TCCCCAATCCA -> CCCCAATCCAC
CCCCAATCCAC -> CCCAATCCACT
CCCAATCCACT -> CCAATCCACTA
CCAATCCACTA -> CAATCCACTAT
CAATCCACTAT -> AATCCACTATT
AATCCACTATT -> ATCCACTATTA
ATCCACTATTA -> TCCACTATTAC
TCCACTATTAC -> CCACTATTACC
CCACTATTACC -> CACTATTACCC
CACTATTACCC -> ACTATTACCCC
ACTATTACCCC -> CTATTACCCCC
CTATTACCCCC -> TATTACCCCCC
TATTACCCCCC -> ATTACCCCCCT
ATTACCCCCCT -> TTACCCCCCTA
TTACCCCCCTA -> TACCCCCCTAG
TACCCCCCTAG -> ACCCCCCTAGG
ACCCCCCTAGG -> CCCCCCTAGGT
CCCCCCTAGGT -> CCCCCTAGGTT
CCCCCTAGGTT -> CCCCTAGGTTC
CCCCTAGGTTC -> CCCTAGGTTCC
CCCTAGGTTCC -> CCTAGGTTCCT
CCTAGGTTCCT -> CTAGGTTCCTC
CTAGGTTCCTC -> TAGGTTCCTCG
TAGGTTCCTCG -> AGGTTCCTCGC
AGGTTCCTCGC -> GGTTCCTCGCA
GGTTCCTCGCA -> GTTCCTCGCAG
GTTCCTCGCAG -> TTCCTCGCAGG
TTCCTCGCAGG -> TCCTCGCAGGA
TCCTCGCAGGA -> CCTCGCAGGAT
CCTCGCAGGAT -> CTCGCAGGATC
CTCGCAGGATC -> TCGCAGGATCT
TCGCAGGATCT -> CGCAGGATCTG
CGCAGGATCTG -> GCAGGATCTGG
GCAGGATCTGG -> CAGGATCTGGT
CAGGATCTGGT -> AGGATCTGGTC
AGGATCTGGTC -> GGATCTGGTCT
GGATCTGGTCT -> GATCTGGTCTG
GATCTGGTCTG -> ATCTGGTCTGG
ATCTGGTCTGG -> TCTGGTCTGGG
TCTGGTCTGGG -> CTGGTCTGGGT
CTGGTCTGGGT -> TGGTCTGGGTC
TGGTCTGGGTC -> GGTCTGGGTCT
GGTCTGGGTCT -> GTCTGGGTCTC
GTCTGGGTCTC -> TCTGGGTCTCG
TCTGGGTCTCG -> CTGGGTCTCGT
CTGGGTCTCGT -> TGGGTCTCGTG
TGGGTCTCGTG -> GGGTCTCGTGT
GGGTCTCGTGT -> GGTCTCGTGTT
GGTCTCGTGTT -> GTCTCGTGTTT
GTCTCGTGTTT -> TCTCGTGTTTT
TCTCGTGTTTT -> CTCGTGTTTTA
CTCGTGTTTTA -> TCGTGTTTTAG
TCGTGTTTTAG -> CGTGTTTTAGA
CGTGTTTTAGA -> GTGTTTTAGAG
GTGTTTTAGAG -> TGTTTTAGAGG
TGTTTTAGAGG -> GTTTTAGAGGA
GTTTTAGAGGA -> TTTTAGAGGAT
TTTTAGAGGAT -> TTTAGAGGATA
TTTAGAGGATA -> TTAGAGGATAG
TTAGAGGATAG -> TAGAGGATAGC
TAGAGGATAGC -> AGAGGATAGCT
AGAGGATAGCT -> GAGGATAGCTA
GAGGATAGCTA -> AGGATAGCTAT
AGGATAGCTAT -> GGATAGCTATA
GGATAGCTATA -> GATAGCTATAA
GATAGCTATAA -> ATAGCTATAAA
ATAGCTATAAA -> TAGCTATAAAT
TAGCTATAAAT -> AGCTATAAATT
AGCTATAAATT -> GCTATAAATTC
GCTATAAATTC -> CTATAAATTCA
CTATAAATTCA -> TATAAATTCAC
TATAAATTCAC -> ATAAATTCACT
ATAAATTCACT -> TAAATTCACTT
TAAATTCACTT -> AAATTCACTTG
AAATTCACTTG -> AATTCACTTGT
AATTCACTTGT -> ATTCACTTGTG
ATTCACTTGTG -> TTCACTTGTGG
TTCACTTGTGG -> TCACTTGTGGT
TCACTTGTGGT -> CACTTGTGGTC
CACTTGTGGTC -> ACTTGTGGTCC
ACTTGTGGTCC -> CTTGTGGTCCT
CTTGTGGTCCT -> TTGTGGTCCTA
TTGTGGTCCTA -> TGTGGTCCTAA
TGTGGTCCTAA -> GTGGTCCTAAT
GTGGTCCTAAT -> TGGTCCTAATA
TGGTCCTAATA -> GGTCCTAATAC
GGTCCTAATAC -> GTCCTAATACT
GTCCTAATACT -> TCCTAATACTG
TCCTAATACTG -> CCTAATACTGC
CCTAATACTGC -> CTAATACTGCC
CTAATACTGCC -> TAATACTGCCC
TAATACTGCCC -> AATACTGCCCC
AATACTGCCCC -> ATACTGCCCCG
ATACTGCCCCG -> TACTGCCCCGT
TACTGCCCCGT -> ACTGCCCCGTC
ACTGCCCCGTC -> CTGCCCCGTCA
CTGCCCCGTCA -> TGCCCCGTCAA
TGCCCCGTCAA -> GCCCCGTCAAG
GCCCCGTCAAG -> CCCCGTCAAGA
CCCCGTCAAGA -> CCCGTCAAGAA
CCCGTCAAGAA -> CCGTCAAGAAG
CCGTCAAGAAG -> CGTCAAGAAGA
CGTCAAGAAGA -> GTCAAGAAGAA
GTCAAGAAGAA -> TCAAGAAGAAA
TCAAGAAGAAA -> CAAGAAGAAAC
CAAGAAGAAAC -> AAGAAGAAACG
AAGAAGAAACG -> AGAAGAAACGT
AGAAGAAACGT -> GAAGAAACGTT
GAAGAAACGTT -> AAGAAACGTTG
AAGAAACGTTG -> AGAAACGTTGT
AGAAACGTTGT -> GAAACGTTGTA
GAAACGTTGTA -> AAACGTTGTAC
AAACGTTGTAC -> AACGTTGTACG
AACGTTGTACG -> ACGTTGTACGT
ACGTTGTACGT -> CGTTGTACGTT
CGTTGTACGTT -> GTTGTACGTTG
GTTGTACGTTG -> TTGTACGTTGC
TTGTACGTTGC -> TGTACGTTGCG
TGTACGTTGCG -> GTACGTTGCGA
GTACGTTGCGA -> TACGTTGCGAT
TACGTTGCGAT -> ACGTTGCGATT
ACGTTGCGATT -> CGTTGCGATTG
CGTTGCGATTG -> GTTGCGATTGT
GTTGCGATTGT -> TTGCGATTGTC
TTGCGATTGTC -> TGCGATTGTCG
TGCGATTGTCG -> GCGATTGTCGA
GCGATTGTCGA -> CGATTGTCGAA
CGATTGTCGAA -> GATTGTCGAAC
GATTGTCGAAC -> ATTGTCGAACG
ATTGTCGAACG -> TTGTCGAACGT
TTGTCGAACGT -> TGTCGAACGTC
TGTCGAACGTC -> GTCGAACGTCT
GTCGAACGTCT -> TCGAACGTCTC
TCGAACGTCTC -> CGAACGTCTCA
CGAACGTCTCA -> GAACGTCTCAC
GAACGTCTCAC -> AACGTCTCACG
AACGTCTCACG -> ACGTCTCACGT
ACGTCTCACGT -> CGTCTCACGTT
CGTCTCACGTT -> GTCTCACGTTC
GTCTCACGTTC -> TCTCACGTTCT
TCTCACGTTCT -> CTCACGTTCTC
CTCACGTTCTC -> TCACGTTCTCT
TCACGTTCTCT -> CACGTTCTCTG
CACGTTCTCTG -> ACGTTCTCTGT
ACGTTCTCTGT -> CGTTCTCTGTC
CGTTCTCTGTC -> GTTCTCTGTCT
GTTCTCTGTCT -> TTCTCTGTCTG
TTCTCTGTCTG -> TCTCTGTCTGA
TCTCTGTCTGA -> CTCTGTCTGAA
CTCTGTCTGAA -> TCTGTCTGAAT
TCTGTCTGAAT -> CTGTCTGAATT
CTGTCTGAATT -> TGTCTGAATTT
TGTCTGAATTT -> GTCTGAATTTA
GTCTGAATTTA -> TCTGAATTTAG
TCTGAATTTAG -> CTGAATTTAGT
CTGAATTTAGT -> TGAATTTAGTG
TGAATTTAGTG -> GAATTTAGTGC
GAATTTAGTGC -> AATTTAGTGCT
AATTTAGTGCT -> ATTTAGTGCTT
ATTTAGTGCTT -> TTTAGTGCTTA
TTTAGTGCTTA -> TTAGTGCTTAC
TTAGTGCTTAC -> TAGTGCTTACC
TAGTGCTTACC -> AGTGCTTACCT
AGTGCTTACCT -> GTGCTTACCTG
GTGCTTACCTG -> TGCTTACCTGT
TGCTTACCTGT -> GCTTACCTGTC
GCTTACCTGTC -> CTTACCTGTCA
CTTACCTGTCA -> TTACCTGTCAC
TTACCTGTCAC -> TACCTGTCACG
TACCTGTCACG -> ACCTGTCACGG
ACCTGTCACGG -> CCTGTCACGGC
CCTGTCACGGC -> CTGTCACGGCA
CTGTCACGGCA -> TGTCACGGCAA
TGTCACGGCAA -> GTCACGGCAAG
GTCACGGCAAG -> TCACGGCAAGC
TCACGGCAAGC -> CACGGCAAGCA
CACGGCAAGCA -> ACGGCAAGCAA
ACGGCAAGCAA -> CGGCAAGCAAG
CGGCAAGCAAG -> GGCAAGCAAGG
GGCAAGCAAGG -> GCAAGCAAGGT
GCAAGCAAGGT -> CAAGCAAGGTT
CAAGCAAGGTT -> AAGCAAGGTTA
AAGCAAGGTTA -> AGCAAGGTTAA
AGCAAGGTTAA -> GCAAGGTTAAT
GCAAGGTTAAT -> CAAGGTTAATG
CAAGGTTAATG -> AAGGTTAATGC
AAGGTTAATGC -> AGGTTAATGCA
AGGTTAATGCA -> GGTTAATGCAA
GGTTAATGCAA -> GTTAATGCAAT
GTTAATGCAAT -> TTAATGCAATA
TTAATGCAATA -> TAATGCAATAG
TAATGCAATAG -> AATGCAATAGA
AATGCAATAGA -> ATGCAATAGAA
ATGCAATAGAA -> TGCAATAGAAC
TGCAATAGAAC -> GCAATAGAACA
GCAATAGAACA -> CAATAGAACAA
CAATAGAACAA -> AATAGAACAAA
AATAGAACAAA -> ATAGAACAAAG
ATAGAACAAAG -> TAGAACAAAGG
TAGAACAAAGG -> AGAACAAAGGA
AGAACAAAGGA -> GAACAAAGGAG
GAACAAAGGAG -> AACAAAGGAGA
AACAAAGGAGA -> ACAAAGGAGAG
ACAAAGGAGAG -> CAAAGGAGAGA
CAAAGGAGAGA -> AAAGGAGAGAC
AAAGGAGAGAC -> AAGGAGAGACG
AAGGAGAGACG -> AGGAGAGACGC
AGGAGAGACGC -> GGAGAGACGCA
GGAGAGACGCA -> GAGAGACGCAG
GAGAGACGCAG -> AGAGACGCAGC
AGAGACGCAGC -> GAGACGCAGCA
GAGACGCAGCA -> AGACGCAGCAA
AGACGCAGCAA -> GACGCAGCAAA
GACGCAGCAAA -> ACGCAGCAAAT
ACGCAGCAAAT -> CGCAGCAAATC
CGCAGCAAATC -> GCAGCAAATCC
GCAGCAAATCC -> CAGCAAATCCC
CAGCAAATCCC -> AGCAAATCCCT
AGCAAATCCCT -> GCAAATCCCTC
GCAAATCCCTC -> CAAATCCCTCG
CAAATCCCTCG -> AAATCCCTCGT
AAATCCCTCGT -> AATCCCTCGTC
AATCCCTCGTC -> ATCCCTCGTCA
ATCCCTCGTCA -> TCCCTCGTCAT
TCCCTCGTCAT -> CCCTCGTCATA
CCCTCGTCATA -> CCTCGTCATAA
CCTCGTCATAA -> CTCGTCATAAC
CTCGTCATAAC -> TCGTCATAACA
TCGTCATAACA -> CGTCATAACAG
CGTCATAACAG -> GTCATAACAGA
GTCATAACAGA -> TCATAACAGAG
TCATAACAGAG -> CATAACAGAGC
CATAACAGAGC -> ATAACAGAGCG
ATAACAGAGCG -> TAACAGAGCGG
TAACAGAGCGG -> AACAGAGCGGG
AACAGAGCGGG -> ACAGAGCGGGC
ACAGAGCGGGC -> CAGAGCGGGCA
CAGAGCGGGCA -> AGAGCGGGCAG
AGAGCGGGCAG -> GAGCGGGCAGA
GAGCGGGCAGA -> AGCGGGCAGAC
AGCGGGCAGAC -> GCGGGCAGACA
GCGGGCAGACA -> CGGGCAGACAG
CGGGCAGACAG -> GGGCAGACAGA
GGGCAGACAGA -> GGCAGACAGAC
GGCAGACAGAC -> GCAGACAGACT
GCAGACAGACT -> CAGACAGACTC
CAGACAGACTC -> AGACAGACTCC
AGACAGACTCC -> GACAGACTCCT
GACAGACTCCT -> ACAGACTCCTC
ACAGACTCCTC -> CAGACTCCTCT
CAGACTCCTCT -> AGACTCCTCTA
AGACTCCTCTA -> GACTCCTCTAT
GACTCCTCTAT -> ACTCCTCTATT
ACTCCTCTATT -> CTCCTCTATTG
CTCCTCTATTG -> TCCTCTATTGT
TCCTCTATTGT -> CCTCTATTGTT
CCTCTATTGTT -> CTCTATTGTTG
CTCTATTGTTG -> TCTATTGTTGA
TCTATTGTTGA -> CTATTGTTGAA
CTATTGTTGAA -> TATTGTTGAAG
TATTGTTGAAG -> ATTGTTGAAGG
ATTGTTGAAGG -> TTGTTGAAGGT
TTGTTGAAGGT -> TGTTGAAGGTA
TGTTGAAGGTA -> GTTGAAGGTAT
GTTGAAGGTAT -> TTGAAGGTATA
TTGAAGGTATA -> TGAAGGTATAC
TGAAGGTATAC -> GAAGGTATACG
GAAGGTATACG -> AAGGTATACGG
AAGGTATACGG -> AGGTATACGGC
AGGTATACGGC -> GGTATACGGCA
GGTATACGGCA -> GTATACGGCAG
GTATACGGCAG -> TATACGGCAGT
TATACGGCAGT -> ATACGGCAGTG
ATACGGCAGTG -> TACGGCAGTGC
TACGGCAGTGC -> ACGGCAGTGCC
ACGGCAGTGCC -> CGGCAGTGCCG
CGGCAGTGCCG -> GGCAGTGCCGA
GGCAGTGCCGA -> GCAGTGCCGAA
GCAGTGCCGAA -> CAGTGCCGAAA
CAGTGCCGAAA -> AGTGCCGAAAT
AGTGCCGAAAT -> GTGCCGAAATG
GTGCCGAAATG -> TGCCGAAATGT
TGCCGAAATGT -> GCCGAAATGTG
GCCGAAATGTG -> CCGAAATGTGT
CCGAAATGTGT -> CGAAATGTGTC
CGAAATGTGTC -> GAAATGTGTCT
GAAATGTGTCT -> AAATGTGTCTT
AAATGTGTCTT -> AATGTGTCTTC
AATGTGTCTTC -> ATGTGTCTTCC
ATGTGTCTTCC -> TGTGTCTTCCA
TGTGTCTTCCA -> GTGTCTTCCAG
GTGTCTTCCAG -> TGTCTTCCAGA
TGTCTTCCAGA -> GTCTTCCAGAC
GTCTTCCAGAC -> TCTTCCAGACT
TCTTCCAGACT -> CTTCCAGACTC
CTTCCAGACTC -> TTCCAGACTCT
TTCCAGACTCT -> TCCAGACTCTC
TCCAGACTCTC -> CCAGACTCTCT
CCAGACTCTCT -> CAGACTCTCTC
CAGACTCTCTC -> AGACTCTCTCC
AGACTCTCTCC -> GACTCTCTCCA
GACTCTCTCCA -> ACTCTCTCCAG
ACTCTCTCCAG -> CTCTCTCCAGG
CTCTCTCCAGG -> TCTCTCCAGGG
TCTCTCCAGGG -> CTCTCCAGGGC
CTCTCCAGGGC -> TCTCCAGGGCG
TCTCCAGGGCG -> CTCCAGGGCGC
CTCCAGGGCGC -> TCCAGGGCGCC
TCCAGGGCGCC -> CCAGGGCGCCT
CCAGGGCGCCT -> CAGGGCGCCTA
CAGGGCGCCTA -> AGGGCGCCTAG
AGGGCGCCTAG -> GGGCGCCTAGT
GGGCGCCTAGT -> GGCGCCTAGTT
GGCGCCTAGTT -> GCGCCTAGTTA
GCGCCTAGTTA -> CGCCTAGTTAA
CGCCTAGTTAA -> GCCTAGTTAAT
GCCTAGTTAAT -> CCTAGTTAATA
CCTAGTTAATA -> CTAGTTAATAG
CTAGTTAATAG -> TAGTTAATAGT
TAGTTAATAGT -> AGTTAATAGTC
AGTTAATAGTC -> GTTAATAGTCA
GTTAATAGTCA -> TTAATAGTCAA
TTAATAGTCAA -> TAATAGTCAAG
TAATAGTCAAG -> AATAGTCAAGA
AATAGTCAAGA -> ATAGTCAAGAT
ATAGTCAAGAT -> TAGTCAAGATA
TAGTCAAGATA -> AGTCAAGATAC
AGTCAAGATAC -> GTCAAGATACC
GTCAAGATACC -> TCAAGATACCC
TCAAGATACCC -> CAAGATACCCG
CAAGATACCCG -> AAGATACCCGT
AAGATACCCGT -> AGATACCCGTA
AGATACCCGTA -> GATACCCGTAC
GATACCCGTAC -> ATACCCGTACG
ATACCCGTACG -> TACCCGTACGC
TACCCGTACGC -> ACCCGTACGCG
ACCCGTACGCG -> CCCGTACGCGA
CCCGTACGCGA -> CCGTACGCGAA
CCGTACGCGAA -> CGTACGCGAAG
CGTACGCGAAG -> GTACGCGAAGG
GTACGCGAAGG -> TACGCGAAGGT
TACGCGAAGGT -> ACGCGAAGGTG
ACGCGAAGGTG -> CGCGAAGGTGC
CGCGAAGGTGC -> GCGAAGGTGCC
GCGAAGGTGCC -> CGAAGGTGCCC
CGAAGGTGCCC -> GAAGGTGCCCA
GAAGGTGCCCA -> AAGGTGCCCAC
AAGGTGCCCAC -> AGGTGCCCACT
AGGTGCCCACT -> GGTGCCCACTT
GGTGCCCACTT -> GTGCCCACTTG
GTGCCCACTTG -> TGCCCACTTGA
TGCCCACTTGA -> GCCCACTTGAA
GCCCACTTGAA -> CCCACTTGAAC
CCCACTTGAAC -> CCACTTGAACA
CCACTTGAACA -> CACTTGAACAG
CACTTGAACAG -> ACTTGAACAGA
ACTTGAACAGA -> CTTGAACAGAA
CTTGAACAGAA -> TTGAACAGAAA
TTGAACAGAAA -> TGAACAGAAAA
TGAACAGAAAA -> GAACAGAAAAG
GAACAGAAAAG -> AACAGAAAAGG
AACAGAAAAGG -> ACAGAAAAGGC
ACAGAAAAGGC -> CAGAAAAGGCA
CAGAAAAGGCA -> AGAAAAGGCAG
AGAAAAGGCAG -> GAAAAGGCAGC
GAAAAGGCAGC -> AAAAGGCAGCC
AAAAGGCAGCC -> AAAGGCAGCCG
AAAGGCAGCCG -> AAGGCAGCCGG
AAGGCAGCCGG -> AGGCAGCCGGG
AGGCAGCCGGG -> GGCAGCCGGGG
GGCAGCCGGGG -> GCAGCCGGGGC
GCAGCCGGGGC -> CAGCCGGGGCT
CAGCCGGGGCT -> AGCCGGGGCTT
AGCCGGGGCTT -> GCCGGGGCTTT
GCCGGGGCTTT -> CCGGGGCTTTC
CCGGGGCTTTC -> CGGGGCTTTCA
CGGGGCTTTCA -> GGGGCTTTCAA
GGGGCTTTCAA -> GGGCTTTCAAG
GGGCTTTCAAG -> GGCTTTCAAGT
GGCTTTCAAGT -> GCTTTCAAGTT
GCTTTCAAGTT -> CTTTCAAGTTT
CTTTCAAGTTT -> TTTCAAGTTTG
TTTCAAGTTTG -> TTCAAGTTTGC
TTCAAGTTTGC -> TCAAGTTTGCG
TCAAGTTTGCG -> CAAGTTTGCGT
CAAGTTTGCGT -> AAGTTTGCGTT
AAGTTTGCGTT -> AGTTTGCGTTG
AGTTTGCGTTG -> GTTTGCGTTGC
GTTTGCGTTGC -> TTTGCGTTGCA
TTTGCGTTGCA -> TTGCGTTGCAT
TTGCGTTGCAT -> TGCGTTGCATT
TGCGTTGCATT -> GCGTTGCATTG
GCGTTGCATTG -> CGTTGCATTGT
CGTTGCATTGT -> GTTGCATTGTA
GTTGCATTGTA -> TTGCATTGTAG
TTGCATTGTAG -> TGCATTGTAGT
TGCATTGTAGT -> GCATTGTAGTG
GCATTGTAGTG -> CATTGTAGTGT
CATTGTAGTGT -> ATTGTAGTGTG
ATTGTAGTGTG -> TTGTAGTGTGT
TTGTAGTGTGT -> TGTAGTGTGTA
TGTAGTGTGTA -> GTAGTGTGTAC
GTAGTGTGTAC -> TAGTGTGTACC
TAGTGTGTACC -> AGTGTGTACCG
AGTGTGTACCG -> GTGTGTACCGA
GTGTGTACCGA -> TGTGTACCGAT
TGTGTACCGAT -> GTGTACCGATT
GTGTACCGATT -> TGTACCGATTG
TGTACCGATTG -> GTACCGATTGA
GTACCGATTGA -> TACCGATTGAG
TACCGATTGAG -> ACCGATTGAGC
ACCGATTGAGC -> CCGATTGAGCT
CCGATTGAGCT -> CGATTGAGCTC
CGATTGAGCTC -> GATTGAGCTCT
GATTGAGCTCT -> ATTGAGCTCTG
ATTGAGCTCTG -> TTGAGCTCTGT
TTGAGCTCTGT -> TGAGCTCTGTG
TGAGCTCTGTG -> GAGCTCTGTGA
GAGCTCTGTGA -> AGCTCTGTGAT
AGCTCTGTGAT -> GCTCTGTGATG
GCTCTGTGATG -> CTCTGTGATGT
CTCTGTGATGT -> TCTGTGATGTT
TCTGTGATGTT -> CTGTGATGTTA
CTGTGATGTTA -> TGTGATGTTAG
TGTGATGTTAG -> GTGATGTTAGC
GTGATGTTAGC -> TGATGTTAGCG
TGATGTTAGCG -> GATGTTAGCGA
GATGTTAGCGA -> ATGTTAGCGAT
ATGTTAGCGAT -> TGTTAGCGATT
TGTTAGCGATT -> GTTAGCGATTC
GTTAGCGATTC -> TTAGCGATTCC
TTAGCGATTCC -> TAGCGATTCCG
TAGCGATTCCG -> AGCGATTCCGT
AGCGATTCCGT -> GCGATTCCGTT
GCGATTCCGTT -> CGATTCCGTTA
CGATTCCGTTA -> GATTCCGTTAT
GATTCCGTTAT -> ATTCCGTTATG
ATTCCGTTATG -> TTCCGTTATGA
TTCCGTTATGA -> TCCGTTATGAA
TCCGTTATGAA -> CCGTTATGAAC
CCGTTATGAAC -> CGTTATGAACC
CGTTATGAACC -> GTTATGAACCG
GTTATGAACCG -> TTATGAACCGG
TTATGAACCGG -> TATGAACCGGG
TATGAACCGGG -> ATGAACCGGGA
ATGAACCGGGA -> TGAACCGGGAG
TGAACCGGGAG -> GAACCGGGAGG
GAACCGGGAGG -> AACCGGGAGGT
AACCGGGAGGT -> ACCGGGAGGTT
ACCGGGAGGTT -> CCGGGAGGTTC
CCGGGAGGTTC -> CGGGAGGTTCT
CGGGAGGTTCT -> GGGAGGTTCTG
GGGAGGTTCTG -> GGAGGTTCTGC
GGAGGTTCTGC -> GAGGTTCTGCC
GAGGTTCTGCC -> AGGTTCTGCCC
AGGTTCTGCCC -> GGTTCTGCCCT
GGTTCTGCCCT -> GTTCTGCCCTA
GTTCTGCCCTA -> TTCTGCCCTAG
TTCTGCCCTAG -> TCTGCCCTAGT
TCTGCCCTAGT -> CTGCCCTAGTC
CTGCCCTAGTC -> TGCCCTAGTCT
TGCCCTAGTCT -> GCCCTAGTCTC
GCCCTAGTCTC -> CCCTAGTCTCA
CCCTAGTCTCA -> CCTAGTCTCAA
CCTAGTCTCAA -> CTAGTCTCAAG
CTAGTCTCAAG -> TAGTCTCAAGC
TAGTCTCAAGC -> AGTCTCAAGCC
AGTCTCAAGCC -> GTCTCAAGCCG
GTCTCAAGCCG -> TCTCAAGCCGG
TCTCAAGCCGG -> CTCAAGCCGGG
CTCAAGCCGGG -> TCAAGCCGGGT
TCAAGCCGGGT -> CAAGCCGGGTT
CAAGCCGGGTT -> AAGCCGGGTTT
AAGCCGGGTTT -> AGCCGGGTTTA
AGCCGGGTTTA -> GCCGGGTTTAT
GCCGGGTTTAT -> CCGGGTTTATC
CCGGGTTTATC -> CGGGTTTATCA
CGGGTTTATCA -> GGGTTTATCAC
GGGTTTATCAC -> GGTTTATCACA
GGTTTATCACA -> GTTTATCACAC
GTTTATCACAC -> TTTATCACACA
TTTATCACACA -> TTATCACACAT
TTATCACACAT -> TATCACACATG
TATCACACATG -> ATCACACATGG
ATCACACATGG -> TCACACATGGG
TCACACATGGG -> CACACATGGGC
CACACATGGGC -> ACACATGGGCT
ACACATGGGCT -> CACATGGGCTC
CACATGGGCTC -> ACATGGGCTCG
ACATGGGCTCG -> CATGGGCTCGA
CATGGGCTCGA -> ATGGGCTCGAC
ATGGGCTCGAC -> TGGGCTCGACA
TGGGCTCGACA -> GGGCTCGACAC
GGGCTCGACAC -> GGCTCGACACG
GGCTCGACACG -> GCTCGACACGA
GCTCGACACGA -> CTCGACACGAG
CTCGACACGAG -> TCGACACGAGT
TCGACACGAGT -> CGACACGAGTA
CGACACGAGTA -> GACACGAGTAG
GACACGAGTAG -> ACACGAGTAGC
ACACGAGTAGC -> CACGAGTAGCC
CACGAGTAGCC -> ACGAGTAGCCC
ACGAGTAGCCC -> CGAGTAGCCCA
CGAGTAGCCCA -> GAGTAGCCCAA
GAGTAGCCCAA -> AGTAGCCCAAC
AGTAGCCCAAC -> GTAGCCCAACT
GTAGCCCAACT -> TAGCCCAACTT
TAGCCCAACTT -> AGCCCAACTTT
AGCCCAACTTT -> GCCCAACTTTT
GCCCAACTTTT -> CCCAACTTTTC
CCCAACTTTTC -> CCAACTTTTCG
CCAACTTTTCG -> CAACTTTTCGT
CAACTTTTCGT -> AACTTTTCGTG
AACTTTTCGTG -> ACTTTTCGTGG
ACTTTTCGTGG -> CTTTTCGTGGG
CTTTTCGTGGG -> TTTTCGTGGGT
TTTTCGTGGGT -> TTTCGTGGGTC
TTTCGTGGGTC -> TTCGTGGGTCT
TTCGTGGGTCT -> TCGTGGGTCTC
TCGTGGGTCTC -> CGTGGGTCTCA
CGTGGGTCTCA -> GTGGGTCTCAG
GTGGGTCTCAG -> TGGGTCTCAGT
TGGGTCTCAGT -> GGGTCTCAGTA
GGGTCTCAGTA -> GGTCTCAGTAA
GGTCTCAGTAA -> GTCTCAGTAAT
GTCTCAGTAAT -> TCTCAGTAATC
TCTCAGTAATC -> CTCAGTAATCA
CTCAGTAATCA -> TCAGTAATCAC
TCAGTAATCAC -> CAGTAATCACA
CAGTAATCACA -> AGTAATCACAA
AGTAATCACAA -> GTAATCACAAA
GTAATCACAAA -> TAATCACAAAG
TAATCACAAAG -> AATCACAAAGC
AATCACAAAGC -> ATCACAAAGCT
ATCACAAAGCT -> TCACAAAGCTG
TCACAAAGCTG -> CACAAAGCTGA
CACAAAGCTGA -> ACAAAGCTGAT
ACAAAGCTGAT -> CAAAGCTGATG
CAAAGCTGATG -> AAAGCTGATGA
AAAGCTGATGA -> AAGCTGATGAT
AAGCTGATGAT -> AGCTGATGATT
AGCTGATGATT -> GCTGATGATTT
GCTGATGATTT -> CTGATGATTTG
CTGATGATTTG -> TGATGATTTGC
TGATGATTTGC -> GATGATTTGCT
GATGATTTGCT -> ATGATTTGCTT
ATGATTTGCTT -> TGATTTGCTTA
TGATTTGCTTA -> GATTTGCTTAC
GATTTGCTTAC -> ATTTGCTTACT
ATTTGCTTACT -> TTTGCTTACTA
TTTGCTTACTA -> TTGCTTACTAC
TTGCTTACTAC -> TGCTTACTACC
TGCTTACTACC -> GCTTACTACCG
GCTTACTACCG -> CTTACTACCGC
CTTACTACCGC -> TTACTACCGCT
TTACTACCGCT -> TACTACCGCTT
TACTACCGCTT -> ACTACCGCTTA
ACTACCGCTTA -> CTACCGCTTAA
CTACCGCTTAA -> TACCGCTTAAT
TACCGCTTAAT -> ACCGCTTAATG
ACCGCTTAATG -> CCGCTTAATGA
CCGCTTAATGA -> CGCTTAATGAG
CGCTTAATGAG -> GCTTAATGAGG
GCTTAATGAGG -> CTTAATGAGGA
CTTAATGAGGA -> TTAATGAGGAC
TTAATGAGGAC -> TAATGAGGACT
TAATGAGGACT -> AATGAGGACTA
AATGAGGACTA -> ATGAGGACTAT
ATGAGGACTAT -> TGAGGACTATC
TGAGGACTATC -> GAGGACTATCA
GAGGACTATCA -> AGGACTATCAA
AGGACTATCAA -> GGACTATCAAG
GGACTATCAAG -> GACTATCAAGC
GACTATCAAGC -> ACTATCAAGCT
ACTATCAAGCT -> CTATCAAGCTC
CTATCAAGCTC -> TATCAAGCTCC
TATCAAGCTCC -> ATCAAGCTCCA
ATCAAGCTCCA -> TCAAGCTCCAA
TCAAGCTCCAA -> CAAGCTCCAAT
CAAGCTCCAAT -> AAGCTCCAATG
AAGCTCCAATG -> AGCTCCAATGT
AGCTCCAATGT -> GCTCCAATGTT
GCTCCAATGTT -> CTCCAATGTTA
CTCCAATGTTA -> TCCAATGTTAT
TCCAATGTTAT -> CCAATGTTATC
CCAATGTTATC -> CAATGTTATCA
CAATGTTATCA -> AATGTTATCAT
AATGTTATCAT -> ATGTTATCATT
ATGTTATCATT -> TGTTATCATTA
TGTTATCATTA -> GTTATCATTAT
GTTATCATTAT -> TTATCATTATT
TTATCATTATT -> TATCATTATTT
TATCATTATTT -> ATCATTATTTC
ATCATTATTTC -> TCATTATTTCT
TCATTATTTCT -> CATTATTTCTC
CATTATTTCTC -> ATTATTTCTCT
ATTATTTCTCT -> TTATTTCTCTT
TTATTTCTCTT -> TATTTCTCTTA
TATTTCTCTTA -> ATTTCTCTTAA
ATTTCTCTTAA -> TTTCTCTTAAG
TTTCTCTTAAG -> TTCTCTTAAGT
TTCTCTTAAGT -> TCTCTTAAGTC
TCTCTTAAGTC -> CTCTTAAGTCG
CTCTTAAGTCG -> TCTTAAGTCGT
TCTTAAGTCGT -> CTTAAGTCGTT
CTTAAGTCGTT -> TTAAGTCGTTT
TTAAGTCGTTT -> TAAGTCGTTTT
TAAGTCGTTTT -> AAGTCGTTTTG
AAGTCGTTTTG -> AGTCGTTTTGG
AGTCGTTTTGG -> GTCGTTTTGGA
GTCGTTTTGGA -> TCGTTTTGGAG
TCGTTTTGGAG -> CGTTTTGGAGC
CGTTTTGGAGC -> GTTTTGGAGCG
GTTTTGGAGCG -> TTTTGGAGCGG
TTTTGGAGCGG -> TTTGGAGCGGA
TTTGGAGCGGA -> TTGGAGCGGAA
TTGGAGCGGAA -> TGGAGCGGAAC
TGGAGCGGAAC -> GGAGCGGAACT
GGAGCGGAACT -> GAGCGGAACTG
GAGCGGAACTG -> AGCGGAACTGG
AGCGGAACTGG -> GCGGAACTGGG
GCGGAACTGGG -> CGGAACTGGGA
CGGAACTGGGA -> GGAACTGGGAA
GGAACTGGGAA -> GAACTGGGAAC
GAACTGGGAAC -> AACTGGGAACC
AACTGGGAACC -> ACTGGGAACCA
ACTGGGAACCA -> CTGGGAACCAA
CTGGGAACCAA -> TGGGAACCAAA
TGGGAACCAAA -> GGGAACCAAAC
GGGAACCAAAC -> GGAACCAAACT
GGAACCAAACT -> GAACCAAACTC
GAACCAAACTC -> AACCAAACTCT
AACCAAACTCT -> ACCAAACTCTG
ACCAAACTCTG -> CCAAACTCTGC
CCAAACTCTGC -> CAAACTCTGCT
CAAACTCTGCT -> AAACTCTGCTG
AAACTCTGCTG -> AACTCTGCTGC
AACTCTGCTGC -> ACTCTGCTGCA
ACTCTGCTGCA -> CTCTGCTGCAT
CTCTGCTGCAT -> TCTGCTGCATG
TCTGCTGCATG -> CTGCTGCATGC
CTGCTGCATGC -> TGCTGCATGCT
TGCTGCATGCT -> GCTGCATGCTG
GCTGCATGCTG -> CTGCATGCTGT
CTGCATGCTGT -> TGCATGCTGTA
TGCATGCTGTA -> GCATGCTGTAC
GCATGCTGTAC -> CATGCTGTACA
CATGCTGTACA -> ATGCTGTACAA
ATGCTGTACAA -> TGCTGTACAAA
TGCTGTACAAA -> GCTGTACAAAT
GCTGTACAAAT -> CTGTACAAATA
CTGTACAAATA -> TGTACAAATAT
TGTACAAATAT -> GTACAAATATA
GTACAAATATA -> TACAAATATAT
TACAAATATAT -> ACAAATATATA
ACAAATATATA -> CAAATATATAA
CAAATATATAA -> AAATATATAAG
AAATATATAAG -> AATATATAAGA
AATATATAAGA -> ATATATAAGAT
ATATATAAGAT -> TATATAAGATA
TATATAAGATA -> ATATAAGATAT
ATATAAGATAT -> TATAAGATATT
TATAAGATATT -> ATAAGATATTA
ATAAGATATTA -> TAAGATATTAA
TAAGATATTAA -> AAGATATTAAT
AAGATATTAAT -> AGATATTAATT
AGATATTAATT -> GATATTAATTG
GATATTAATTG -> ATATTAATTGC
ATATTAATTGC -> TATTAATTGCA
TATTAATTGCA -> ATTAATTGCAC
ATTAATTGCAC -> TTAATTGCACT
TTAATTGCACT -> TAATTGCACTA
TAATTGCACTA -> AATTGCACTAT
AATTGCACTAT -> ATTGCACTATT
ATTGCACTATT -> TTGCACTATTA
TTGCACTATTA -> TGCACTATTAG
TGCACTATTAG -> GCACTATTAGT
GCACTATTAGT -> CACTATTAGTT
CACTATTAGTT -> ACTATTAGTTC
ACTATTAGTTC -> CTATTAGTTCA
CTATTAGTTCA -> TATTAGTTCAT
TATTAGTTCAT -> ATTAGTTCATT
ATTAGTTCATT -> TTAGTTCATTC
TTAGTTCATTC -> TAGTTCATTCG
TAGTTCATTCG -> AGTTCATTCGC
AGTTCATTCGC -> GTTCATTCGCG
GTTCATTCGCG -> TTCATTCGCGG
TTCATTCGCGG -> TCATTCGCGGG
TCATTCGCGGG -> CATTCGCGGGA
CATTCGCGGGA -> ATTCGCGGGAG
ATTCGCGGGAG -> TTCGCGGGAGA
TTCGCGGGAGA -> TCGCGGGAGAG
TCGCGGGAGAG -> CGCGGGAGAGC
CGCGGGAGAGC -> GCGGGAGAGCC
GCGGGAGAGCC -> CGGGAGAGCCT
CGGGAGAGCCT -> GGGAGAGCCTG
GGGAGAGCCTG -> GGAGAGCCTGG
GGAGAGCCTGG -> GAGAGCCTGGT
GAGAGCCTGGT -> AGAGCCTGGTC
AGAGCCTGGTC -> GAGCCTGGTCT
GAGCCTGGTCT -> AGCCTGGTCTA
AGCCTGGTCTA -> GCCTGGTCTAG
GCCTGGTCTAG -> CCTGGTCTAGA
CCTGGTCTAGA -> CTGGTCTAGAA
CTGGTCTAGAA -> TGGTCTAGAAC
TGGTCTAGAAC -> GGTCTAGAACC
GGTCTAGAACC -> GTCTAGAACCG
GTCTAGAACCG -> TCTAGAACCGC
TCTAGAACCGC -> CTAGAACCGCT
CTAGAACCGCT -> TAGAACCGCTT
TAGAACCGCTT -> AGAACCGCTTG
AGAACCGCTTG -> GAACCGCTTGC
GAACCGCTTGC -> AACCGCTTGCC
AACCGCTTGCC -> ACCGCTTGCCC
ACCGCTTGCCC -> CCGCTTGCCCG
CCGCTTGCCCG -> CGCTTGCCCGG
CGCTTGCCCGG -> GCTTGCCCGGG
GCTTGCCCGGG -> CTTGCCCGGGG
CTTGCCCGGGG -> TTGCCCGGGGC
TTGCCCGGGGC -> TGCCCGGGGCT
TGCCCGGGGCT -> GCCCGGGGCTA
GCCCGGGGCTA -> CCCGGGGCTAA
CCCGGGGCTAA -> CCGGGGCTAAC
CCGGGGCTAAC -> CGGGGCTAACC
CGGGGCTAACC -> GGGGCTAACCT
GGGGCTAACCT -> GGGCTAACCTT
GGGCTAACCTT -> GGCTAACCTTC
GGCTAACCTTC -> GCTAACCTTCA
GCTAACCTTCA -> CTAACCTTCAT
CTAACCTTCAT -> TAACCTTCATG
TAACCTTCATG -> AACCTTCATGC
AACCTTCATGC -> ACCTTCATGCG
ACCTTCATGCG -> CCTTCATGCGC
CCTTCATGCGC -> CTTCATGCGCT
CTTCATGCGCT -> TTCATGCGCTT
TTCATGCGCTT -> TCATGCGCTTT
TCATGCGCTTT -> CATGCGCTTTG
CATGCGCTTTG -> ATGCGCTTTGT
ATGCGCTTTGT -> TGCGCTTTGTT
TGCGCTTTGTT -> GCGCTTTGTTT
GCGCTTTGTTT -> CGCTTTGTTTT
CGCTTTGTTTT -> GCTTTGTTTTT
GCTTTGTTTTT -> CTTTGTTTTTT
CTTTGTTTTTT -> TTTGTTTTTTG
TTTGTTTTTTG -> TTGTTTTTTGT
TTGTTTTTTGT -> TGTTTTTTGTC
TGTTTTTTGTC -> GTTTTTTGTCG
GTTTTTTGTCG -> TTTTTTGTCGT
TTTTTTGTCGT -> TTTTTGTCGTG
TTTTTGTCGTG -> TTTTGTCGTGG
TTTTGTCGTGG -> TTTGTCGTGGG
TTTGTCGTGGG -> TTGTCGTGGGC
TTGTCGTGGGC -> TGTCGTGGGCA
TGTCGTGGGCA -> GTCGTGGGCAT
GTCGTGGGCAT -> TCGTGGGCATG
TCGTGGGCATG -> CGTGGGCATGG
CGTGGGCATGG -> GTGGGCATGGT
GTGGGCATGGT -> TGGGCATGGTG
TGGGCATGGTG -> GGGCATGGTGG
GGGCATGGTGG -> GGCATGGTGGG
GGCATGGTGGG -> GCATGGTGGGG
GCATGGTGGGG -> CATGGTGGGGT
CATGGTGGGGT -> ATGGTGGGGTT
ATGGTGGGGTT -> TGGTGGGGTTC
TGGTGGGGTTC -> GGTGGGGTTCG
GGTGGGGTTCG -> GTGGGGTTCGC
GTGGGGTTCGC -> TGGGGTTCGCG
TGGGGTTCGCG -> GGGGTTCGCGC
GGGGTTCGCGC -> GGGTTCGCGCG
GGGTTCGCGCG -> GGTTCGCGCGT
GGTTCGCGCGT -> GTTCGCGCGTA
GTTCGCGCGTA -> TTCGCGCGTAT
TTCGCGCGTAT -> TCGCGCGTATA
TCGCGCGTATA -> CGCGCGTATAG
CGCGCGTATAG -> GCGCGTATAGC
GCGCGTATAGC -> CGCGTATAGCG
CGCGTATAGCG -> GCGTATAGCGG
GCGTATAGCGG -> CGTATAGCGGA
CGTATAGCGGA -> GTATAGCGGAG
GTATAGCGGAG -> TATAGCGGAGT
TATAGCGGAGT -> ATAGCGGAGTC
ATAGCGGAGTC -> TAGCGGAGTCT
TAGCGGAGTCT -> AGCGGAGTCTA
AGCGGAGTCTA -> GCGGAGTCTAT
GCGGAGTCTAT -> CGGAGTCTATC
CGGAGTCTATC -> GGAGTCTATCC
GGAGTCTATCC -> GAGTCTATCCC
GAGTCTATCCC -> AGTCTATCCCT
AGTCTATCCCT -> GTCTATCCCTG
GTCTATCCCTG -> TCTATCCCTGC
TCTATCCCTGC -> CTATCCCTGCC
CTATCCCTGCC -> TATCCCTGCCG
TATCCCTGCCG -> ATCCCTGCCGT
ATCCCTGCCGT -> TCCCTGCCGTG
TCCCTGCCGTG -> CCCTGCCGTGT
CCCTGCCGTGT -> CCTGCCGTGTG
CCTGCCGTGTG -> CTGCCGTGTGG
CTGCCGTGTGG -> TGCCGTGTGGT
TGCCGTGTGGT -> GCCGTGTGGTC
GCCGTGTGGTC -> CCGTGTGGTCT
CCGTGTGGTCT -> CGTGTGGTCTC
