CATCACGCGGCAGCTATTTC -> ATCACGCGGCAGCTATTTCT
TCGTCGCAAGTGGGGGTCTG -> CGTCGCAAGTGGGGGTCTGT
TCCGTGTTTGCGGCATAAAC -> CCGTGTTTGCGGCATAAACG
CCACTAGGACATCAGGACAA -> CACTAGGACATCAGGACAAA
CTGTTCGTTGCGAATTAAGA -> TGTTCGTTGCGAATTAAGAC
AAATAATCGTTGTGGAACCC -> AATAATCGTTGTGGAACCCT
TATGCCAGCACTGTTCGTTG -> ATGCCAGCACTGTTCGTTGC
GGAACAAGGGTAGAACCCCT -> GAACAAGGGTAGAACCCCTC
TGAGGGCCTGGGACCCAGTG -> GAGGGCCTGGGACCCAGTGA
ACTGGTAGCTAACTGGGTGT -> CTGGTAGCTAACTGGGTGTT
GCGGATGGAAAATGCTCAAG -> CGGATGGAAAATGCTCAAGA
TGAGAAGCTTATATGTCGGT -> GAGAAGCTTATATGTCGGTG
AACATCCTCGTCTTCGACTG -> ACATCCTCGTCTTCGACTGG
AAAATGCTCAAGATATACTA -> AAATGCTCAAGATATACTAC
TTTGCACTCGTGTTGGCGTC -> TTGCACTCGTGTTGGCGTCA
CATTATCTGGCCCGATACGG -> ATTATCTGGCCCGATACGGG
GACAAATGACTCGTCGCGTA -> ACAAATGACTCGTCGCGTAC
GCAGGGCGTTATAAACGAAC -> CAGGGCGTTATAAACGAACT
AGTGCCGAACCACTAGGACA -> GTGCCGAACCACTAGGACAT
TCTGGTAAAGTATCATATCG -> CTGGTAAAGTATCATATCGT
GTGCCTAGCCCCAAGGACGC -> TGCCTAGCCCCAAGGACGCC
TGGGTGTTTTTAGTCAATTT -> GGGTGTTTTTAGTCAATTTC
TTGTTGGGCGGAACCGTTGG -> TGTTGGGCGGAACCGTTGGT
CGTTGGTCAGTCAGGCGGTG -> GTTGGTCAGTCAGGCGGTGG
TTTGGCGCCAGGATTCCATT -> TTGGCGCCAGGATTCCATTA
GCGGCAGCTATTTCTTATAA -> CGGCAGCTATTTCTTATAAC
CCTAGTAAAAACTATGACTT -> CTAGTAAAAACTATGACTTG
ACGCCTGGAGTACACTTCAG -> CGCCTGGAGTACACTTCAGG
GTAAAACACAATTAACCACC -> TAAAACACAATTAACCACCG
ATCACGCGGCAGCTATTTCT -> TCACGCGGCAGCTATTTCTT
GTGTTCCTCAACCGTAATCC -> TGTTCCTCAACCGTAATCCA
ATGACTAAGTAAATGGCTAG -> TGACTAAGTAAATGGCTAGA
CGAACCACTAGGACATCAGG -> GAACCACTAGGACATCAGGA
GCTCGTGAAGTTTTTTATTT -> CTCGTGAAGTTTTTTATTTA
TAGCCCCAAGGACGCCTGGA -> AGCCCCAAGGACGCCTGGAG
CCCGATACGGGTTTAATTCG -> CCGATACGGGTTTAATTCGC
TCATATCGTCGCAAGTGGGG -> CATATCGTCGCAAGTGGGGG
TGGCTAGCTGTCAGTGCCTA -> GGCTAGCTGTCAGTGCCTAG
CTTCAGCCATAGTGTTCCTC -> TTCAGCCATAGTGTTCCTCA
CGTCATCCTCTGTATGAGGG -> GTCATCCTCTGTATGAGGGC
TATCTGGCCCGATACGGGTT -> ATCTGGCCCGATACGGGTTT
ATTGATCCTTCCTTCGGTTT -> TTGATCCTTCCTTCGGTTTT
CAGTAGTTGTTGGGCGGAAC -> AGTAGTTGTTGGGCGGAACC
AGCTTATATGTCGGTGAGCG -> GCTTATATGTCGGTGAGCGA
ATATGCCAGCACTGTTCGTT -> TATGCCAGCACTGTTCGTTG
GGTAACCAGGTAATCAATGT -> GTAACCAGGTAATCAATGTG
GAACAAGGGTAGAACCCCTC -> AACAAGGGTAGAACCCCTCC
TGCTTAGCCTAGTAAAAACT -> GCTTAGCCTAGTAAAAACTA
TTGCAGGTTGTAAAACACAA -> TGCAGGTTGTAAAACACAAT
TAGCCTAGTAAAAACTATGA -> AGCCTAGTAAAAACTATGAC
ATATATTCCGACCCAACACG -> TATATTCCGACCCAACACGG
GGGCCTGGGACCCAGTGAAT -> GGCCTGGGACCCAGTGAATC
CTAGTCCAGGATCGGAACGA -> TAGTCCAGGATCGGAACGAC
AGGACAAATGACTCGTCGCG -> GGACAAATGACTCGTCGCGT
CCATTGATCCTTCCTTCGGT -> CATTGATCCTTCCTTCGGTT
TTGGCGCCAGGATTCCATTA -> TGGCGCCAGGATTCCATTAT
TGGCCCGATACGGGTTTAAT -> GGCCCGATACGGGTTTAATT
GTAGTTGTTGGGCGGAACCG -> TAGTTGTTGGGCGGAACCGT
ATTTCTTATAACTCGTTGAT -> TTTCTTATAACTCGTTGATA
TGAGACAGATCTGGTAAAGT -> GAGACAGATCTGGTAAAGTA
CTAGTAAAAACTATGACTTG -> TAGTAAAAACTATGACTTGA
ATATGTCGGTGAGCGATTTA -> TATGTCGGTGAGCGATTTAG
AAAGTATCATATCGTCGCAA -> AAGTATCATATCGTCGCAAG
AACACAATTAACCACCGTAC -> ACACAATTAACCACCGTACG
CTTATAACTCGTTGATAGCT -> TTATAACTCGTTGATAGCTG
GTCGCGTACTCTAGTCCAGG -> TCGCGTACTCTAGTCCAGGA
AATCAATGTGCGCTCGTGAA -> ATCAATGTGCGCTCGTGAAG
TATAAACGAACTGATGACTA -> ATAAACGAACTGATGACTAA
GATTAACGTTGGTAACCAGG -> ATTAACGTTGGTAACCAGGT
CGCAAGTGGGGGTCTGTTAG -> GCAAGTGGGGGTCTGTTAGA
AGTGAATCCATAGTGCCGAA -> GTGAATCCATAGTGCCGAAC
TATATTCCGACCCAACACGG -> ATATTCCGACCCAACACGGG
CTCCACTCCCATTGATCCTT -> TCCACTCCCATTGATCCTTC
CGAATTAAGACCTGTCGGCG -> GAATTAAGACCTGTCGGCGT
TGGCAATTTCACCGTTAGAT -> GGCAATTTCACCGTTAGATG
GCCTAGCCCCAAGGACGCCT -> CCTAGCCCCAAGGACGCCTG
TACATATATTCCGACCCAAC -> ACATATATTCCGACCCAACA
GCGTTATAAACGAACTGATG -> CGTTATAAACGAACTGATGA
GATATACTACGGAATCCCTT -> ATATACTACGGAATCCCTTT
ACCGTACGACTTTTGCAGCT -> CCGTACGACTTTTGCAGCTG
TTGGTCAGTCAGGCGGTGGC -> TGGTCAGTCAGGCGGTGGCT
GCTTAGCCTAGTAAAAACTA -> CTTAGCCTAGTAAAAACTAT
ATGCCATCCGCCATGTCAGT -> TGCCATCCGCCATGTCAGTT
GTCCAGTAGTTGTTGGGCGG -> TCCAGTAGTTGTTGGGCGGA
CCTTCGGTTTTGGCGCCAGG -> CTTCGGTTTTGGCGCCAGGA
GTACACTTCAGGCAGGGCGT -> TACACTTCAGGCAGGGCGTT
GTGAGAAGCTTATATGTCGG -> TGAGAAGCTTATATGTCGGT
GTAATCAATGTGCGCTCGTG -> TAATCAATGTGCGCTCGTGA
GCAAGTGGGGGTCTGTTAGA -> CAAGTGGGGGTCTGTTAGAC
CCAGTGAATCCATAGTGCCG -> CAGTGAATCCATAGTGCCGA
GGTAGCTAACTGGGTGTTTT -> GTAGCTAACTGGGTGTTTTT
CGCGCGTCCTCGTGTGATGA -> GCGCGTCCTCGTGTGATGAG
GTGGGAACAAGGGTAGAACC -> TGGGAACAAGGGTAGAACCC
TTTAATTCGCCATAAGGAAC -> TTAATTCGCCATAAGGAACA
GATACTTCAGCCATAGTGTT -> ATACTTCAGCCATAGTGTTC
TCATATGCCAGCACTGTTCG -> CATATGCCAGCACTGTTCGT
CTCTAGTCCAGGATCGGAAC -> TCTAGTCCAGGATCGGAACG
TCTGTTAGACTGGTAGCTAA -> CTGTTAGACTGGTAGCTAAC
GTGCGCTCGTGAAGTTTTTT -> TGCGCTCGTGAAGTTTTTTA
TGGGCGGAACCGTTGGTCAG -> GGGCGGAACCGTTGGTCAGT
CGTTGATAGCTGCCTGCGAG -> GTTGATAGCTGCCTGCGAGA
GGCAGCTATTTCTTATAACT -> GCAGCTATTTCTTATAACTC
TAATCAATGTGCGCTCGTGA -> AATCAATGTGCGCTCGTGAA
AATTTCGGTTGTTTGTTTTG -> ATTTCGGTTGTTTGTTTTGT
TATTCCGACCCAACACGGGA -> ATTCCGACCCAACACGGGAG
CAGGTTGTAAAACACAATTA -> AGGTTGTAAAACACAATTAA
TGTTTGTTTTGTGAGAAGCT -> GTTTGTTTTGTGAGAAGCTT
AGGAACATCCTCGTCTTCGA -> GGAACATCCTCGTCTTCGAC
GCACTCGTGTTGGCGTCATA -> CACTCGTGTTGGCGTCATAT
CAGCTATTTCTTATAACTCG -> AGCTATTTCTTATAACTCGT
ACTCTAGTCCAGGATCGGAA -> CTCTAGTCCAGGATCGGAAC
GACCCAGTGAATCCATAGTG -> ACCCAGTGAATCCATAGTGC
TGTTCGTTGCGAATTAAGAC -> GTTCGTTGCGAATTAAGACC
CTCGTGTGATGAGACAGATC -> TCGTGTGATGAGACAGATCT
GTGATGAGACAGATCTGGTA -> TGATGAGACAGATCTGGTAA
TTCGGTTTTGGCGCCAGGAT -> TCGGTTTTGGCGCCAGGATT
TTGTTTTGTGAGAAGCTTAT -> TGTTTTGTGAGAAGCTTATA
CGCCTGGAGTACACTTCAGG -> GCCTGGAGTACACTTCAGGC
GCCCGTGCATCACGCGGCAG -> CCCGTGCATCACGCGGCAGC
TGCCATCCGCCATGTCAGTT -> GCCATCCGCCATGTCAGTTG
TGCGGCATAAACGTTTACAT -> GCGGCATAAACGTTTACATA
TTGCGAATTAAGACCTGTCG -> TGCGAATTAAGACCTGTCGG
CTAAAGCCCGTGCATCACGC -> TAAAGCCCGTGCATCACGCG
TTATCTGGCCCGATACGGGT -> TATCTGGCCCGATACGGGTT
AGCCCGTGCATCACGCGGCA -> GCCCGTGCATCACGCGGCAG
GGGCGTTATAAACGAACTGA -> GGCGTTATAAACGAACTGAT
CTTAGCCTAGTAAAAACTAT -> TTAGCCTAGTAAAAACTATG
TTGTGGAACCCTCGCGATTT -> TGTGGAACCCTCGCGATTTT
CAGTTGTCCAGTAGTTGTTG -> AGTTGTCCAGTAGTTGTTGG
AATTAACCACCGTACGACTT -> ATTAACCACCGTACGACTTT
TGGGTCAAAGCGGATGGAAA -> GGGTCAAAGCGGATGGAAAA
GGCGTTATAAACGAACTGAT -> GCGTTATAAACGAACTGATG
TGTCGGCGTCTTGGGCGTCA -> GTCGGCGTCTTGGGCGTCAT
TCCATAGTGCCGAACCACTA -> CCATAGTGCCGAACCACTAG
TAAAAACTATGACTTGAAAT -> AAAAACTATGACTTGAAATA
CGTCCTCGTGTGATGAGACA -> GTCCTCGTGTGATGAGACAG
TTGGGCGTCATCCTCTGTAT -> TGGGCGTCATCCTCTGTATG
CCAGTAGTTGTTGGGCGGAA -> CAGTAGTTGTTGGGCGGAAC
TAATTCGCCATAAGGAACAT -> AATTCGCCATAAGGAACATC
GGAATCCCTTTGCACTCGTG -> GAATCCCTTTGCACTCGTGT
CGTTATAAACGAACTGATGA -> GTTATAAACGAACTGATGAC
CAGAATGCTTAGCCTAGTAA -> AGAATGCTTAGCCTAGTAAA
AAACTATGACTTGAAATAAT -> AACTATGACTTGAAATAATC
GTGCCGAACCACTAGGACAT -> TGCCGAACCACTAGGACATC
CCGTAATCCACTCCGTGTTT -> CGTAATCCACTCCGTGTTTG
CACCGTTAGATGCCATCCGC -> ACCGTTAGATGCCATCCGCC
ACGTTTACATATATTCCGAC -> CGTTTACATATATTCCGACC
TCAATTTCGGTTGTTTGTTT -> CAATTTCGGTTGTTTGTTTT
GTTGTTTGTTTTGTGAGAAG -> TTGTTTGTTTTGTGAGAAGC
AATTCGCCATAAGGAACATC -> ATTCGCCATAAGGAACATCC
TACTAAAGCCCGTGCATCAC -> ACTAAAGCCCGTGCATCACG
CAGGTAATCAATGTGCGCTC -> AGGTAATCAATGTGCGCTCG
GTAATCCACTCCGTGTTTGC -> TAATCCACTCCGTGTTTGCG
AAAGCGGATGGAAAATGCTC -> AAGCGGATGGAAAATGCTCA
GAAGTTTTTTATTTACAGAA -> AAGTTTTTTATTTACAGAAT
CATAGTGTTCCTCAACCGTA -> ATAGTGTTCCTCAACCGTAA
CGCCAGGATTCCATTATCTG -> GCCAGGATTCCATTATCTGG
CGTTAGATGCCATCCGCCAT -> GTTAGATGCCATCCGCCATG
GGACATCAGGACAAATGACT -> GACATCAGGACAAATGACTC
CAATTTCACCGTTAGATGCC -> AATTTCACCGTTAGATGCCA
AGTATTGCAGGTTGTAAAAC -> GTATTGCAGGTTGTAAAACA
TTGATAGCTGCCTGCGAGAT -> TGATAGCTGCCTGCGAGATT
TTTCGGTTGTTTGTTTTGTG -> TTCGGTTGTTTGTTTTGTGA
TACACTTCAGGCAGGGCGTT -> ACACTTCAGGCAGGGCGTTA
AGCCCCAAGGACGCCTGGAG -> GCCCCAAGGACGCCTGGAGT
TTATTTACAGAATGCTTAGC -> TATTTACAGAATGCTTAGCC
GTCAATTTCGGTTGTTTGTT -> TCAATTTCGGTTGTTTGTTT
ATCAATGTGCGCTCGTGAAG -> TCAATGTGCGCTCGTGAAGT
ATATACTACGGAATCCCTTT -> TATACTACGGAATCCCTTTG
TGACTAAGTAAATGGCTAGA -> GACTAAGTAAATGGCTAGAC
AACACGGGAGTATTGCAGGT -> ACACGGGAGTATTGCAGGTT
CCATAGTGCCGAACCACTAG -> CATAGTGCCGAACCACTAGG
TGACTTGAAATAATCGTTGT -> GACTTGAAATAATCGTTGTG
CATCAGGACAAATGACTCGT -> ATCAGGACAAATGACTCGTC
GCCATAGTGTTCCTCAACCG -> CCATAGTGTTCCTCAACCGT
GACCCAACACGGGAGTATTG -> ACCCAACACGGGAGTATTGC
CATGTCAGTTGTCCAGTAGT -> ATGTCAGTTGTCCAGTAGTT
CGGAACCGTTGGTCAGTCAG -> GGAACCGTTGGTCAGTCAGG
CAACACGGGAGTATTGCAGG -> AACACGGGAGTATTGCAGGT
ATACTTCAGCCATAGTGTTC -> TACTTCAGCCATAGTGTTCC
AGAATGCTTAGCCTAGTAAA -> GAATGCTTAGCCTAGTAAAA
GCATCACGCGGCAGCTATTT -> CATCACGCGGCAGCTATTTC
GCTACCAATACTAAAGCCCG -> CTACCAATACTAAAGCCCGT
AGTGGGGGTCTGTTAGACTG -> GTGGGGGTCTGTTAGACTGG
CTCGTGAAGTTTTTTATTTA -> TCGTGAAGTTTTTTATTTAC
GGAGTGGGAACAAGGGTAGA -> GAGTGGGAACAAGGGTAGAA
TGAAGTTTTTTATTTACAGA -> GAAGTTTTTTATTTACAGAA
TGCACTCGTGTTGGCGTCAT -> GCACTCGTGTTGGCGTCATA
GTGAAGTTTTTTATTTACAG -> TGAAGTTTTTTATTTACAGA
CGGATGGAAAATGCTCAAGA -> GGATGGAAAATGCTCAAGAT
TGTCCAGTAGTTGTTGGGCG -> GTCCAGTAGTTGTTGGGCGG
TGGAGTACACTTCAGGCAGG -> GGAGTACACTTCAGGCAGGG
ACGACTTTTGCAGCTGAATG -> CGACTTTTGCAGCTGAATGG
GATTTTCTAGATAGGAGTGG -> ATTTTCTAGATAGGAGTGGG
GTACGACTTTTGCAGCTGAA -> TACGACTTTTGCAGCTGAAT
TCGTTGCGAATTAAGACCTG -> CGTTGCGAATTAAGACCTGT
ATTTAGATACTTCAGCCATA -> TTTAGATACTTCAGCCATAG
GCGAATTAAGACCTGTCGGC -> CGAATTAAGACCTGTCGGCG
AGGTTGTAAAACACAATTAA -> GGTTGTAAAACACAATTAAC
TGATGAGACAGATCTGGTAA -> GATGAGACAGATCTGGTAAA
GGGTCTGTTAGACTGGTAGC -> GGTCTGTTAGACTGGTAGCT
ACGTTGGTAACCAGGTAATC -> CGTTGGTAACCAGGTAATCA
GTTGGTAACCAGGTAATCAA -> TTGGTAACCAGGTAATCAAT
GACTTGAAATAATCGTTGTG -> ACTTGAAATAATCGTTGTGG
CGTCTTGGGCGTCATCCTCT -> GTCTTGGGCGTCATCCTCTG
TGACTCGTCGCGTACTCTAG -> GACTCGTCGCGTACTCTAGT
CATATCGTCGCAAGTGGGGG -> ATATCGTCGCAAGTGGGGGT
AGTAGTTGTTGGGCGGAACC -> GTAGTTGTTGGGCGGAACCG
AGTCCAGGATCGGAACGACC -> GTCCAGGATCGGAACGACCT
AACGAACTGATGACTAAGTA -> ACGAACTGATGACTAAGTAA
ATCTGGCCCGATACGGGTTT -> TCTGGCCCGATACGGGTTTA
TAGCTGCCTGCGAGATTAAC -> AGCTGCCTGCGAGATTAACG
GTAAAGTATCATATCGTCGC -> TAAAGTATCATATCGTCGCA
GCGTCTTGGGCGTCATCCTC -> CGTCTTGGGCGTCATCCTCT
TCGCAAGTGGGGGTCTGTTA -> CGCAAGTGGGGGTCTGTTAG
CAGCACTGTTCGTTGCGAAT -> AGCACTGTTCGTTGCGAATT
ACTACGGAATCCCTTTGCAC -> CTACGGAATCCCTTTGCACT
CCTGGAGTACACTTCAGGCA -> CTGGAGTACACTTCAGGCAG
TTCAGCCATAGTGTTCCTCA -> TCAGCCATAGTGTTCCTCAA
TAGGAGTGGGAACAAGGGTA -> AGGAGTGGGAACAAGGGTAG
AGATACTTCAGCCATAGTGT -> GATACTTCAGCCATAGTGTT
TCGGTTTTGGCGCCAGGATT -> CGGTTTTGGCGCCAGGATTC
TTCACCGTTAGATGCCATCC -> TCACCGTTAGATGCCATCCG
TAAAGCCCGTGCATCACGCG -> AAAGCCCGTGCATCACGCGG
TCCATTATCTGGCCCGATAC -> CCATTATCTGGCCCGATACG
GCTGCCTGCGAGATTAACGT -> CTGCCTGCGAGATTAACGTT
TACAGAATGCTTAGCCTAGT -> ACAGAATGCTTAGCCTAGTA
AATGCTCAAGATATACTACG -> ATGCTCAAGATATACTACGG
CTGTCAGTGCCTAGCCCCAA -> TGTCAGTGCCTAGCCCCAAG
GAAAATGCTCAAGATATACT -> AAAATGCTCAAGATATACTA
CTGATGACTAAGTAAATGGC -> TGATGACTAAGTAAATGGCT
ACCAATACTAAAGCCCGTGC -> CCAATACTAAAGCCCGTGCA
TGTATGAGGGCCTGGGACCC -> GTATGAGGGCCTGGGACCCA
CAGATCTGGTAAAGTATCAT -> AGATCTGGTAAAGTATCATA
ACCGTTGGTCAGTCAGGCGG -> CCGTTGGTCAGTCAGGCGGT
TTTTGTGAGAAGCTTATATG -> TTTGTGAGAAGCTTATATGT
CGCGTCCTCGTGTGATGAGA -> GCGTCCTCGTGTGATGAGAC
ACCGTAATCCACTCCGTGTT -> CCGTAATCCACTCCGTGTTT
ACTCGTTGATAGCTGCCTGC -> CTCGTTGATAGCTGCCTGCG
GCTTATATGTCGGTGAGCGA -> CTTATATGTCGGTGAGCGAT
CATATGCCAGCACTGTTCGT -> ATATGCCAGCACTGTTCGTT
CCAAGGACGCCTGGAGTACA -> CAAGGACGCCTGGAGTACAC
AGCACTGTTCGTTGCGAATT -> GCACTGTTCGTTGCGAATTA
GCAATTTCACCGTTAGATGC -> CAATTTCACCGTTAGATGCC
TGCATCACGCGGCAGCTATT -> GCATCACGCGGCAGCTATTT
TCAGTGCCTAGCCCCAAGGA -> CAGTGCCTAGCCCCAAGGAC
ACATATATTCCGACCCAACA -> CATATATTCCGACCCAACAC
GAACCGTTGGTCAGTCAGGC -> AACCGTTGGTCAGTCAGGCG
CTAGATAGGAGTGGGAACAA -> TAGATAGGAGTGGGAACAAG
CGCTCGTGAAGTTTTTTATT -> GCTCGTGAAGTTTTTTATTT
TGTGATGAGACAGATCTGGT -> GTGATGAGACAGATCTGGTA
GAATCCCTTTGCACTCGTGT -> AATCCCTTTGCACTCGTGTT
TAGTAAAAACTATGACTTGA -> AGTAAAAACTATGACTTGAA
ATGACTCGTCGCGTACTCTA -> TGACTCGTCGCGTACTCTAG
ATTAACGTTGGTAACCAGGT -> TTAACGTTGGTAACCAGGTA
GTTGTTGGGCGGAACCGTTG -> TTGTTGGGCGGAACCGTTGG
TTTGCGGCATAAACGTTTAC -> TTGCGGCATAAACGTTTACA
TTCAGGCAGGGCGTTATAAA -> TCAGGCAGGGCGTTATAAAC
GAATGGGTCAAAGCGGATGG -> AATGGGTCAAAGCGGATGGA
GCTAGACCGCGCGTCCTCGT -> CTAGACCGCGCGTCCTCGTG
ATTCCGACCCAACACGGGAG -> TTCCGACCCAACACGGGAGT
ACTTGAAATAATCGTTGTGG -> CTTGAAATAATCGTTGTGGA
CGGGTTTAATTCGCCATAAG -> GGGTTTAATTCGCCATAAGG
GCGCTCGTGAAGTTTTTTAT -> CGCTCGTGAAGTTTTTTATT
TAAAGTATCATATCGTCGCA -> AAAGTATCATATCGTCGCAA
TGCGAGATTAACGTTGGTAA -> GCGAGATTAACGTTGGTAAC
TGCAGCTGAATGGGTCAAAG -> GCAGCTGAATGGGTCAAAGC
AGACCGCGCGTCCTCGTGTG -> GACCGCGCGTCCTCGTGTGA
TAAACGTTTACATATATTCC -> AAACGTTTACATATATTCCG
AATCGTTGTGGAACCCTCGC -> ATCGTTGTGGAACCCTCGCG
ATCATATCGTCGCAAGTGGG -> TCATATCGTCGCAAGTGGGG
GCCCGATACGGGTTTAATTC -> CCCGATACGGGTTTAATTCG
GGTTTAATTCGCCATAAGGA -> GTTTAATTCGCCATAAGGAA
CCATTATCTGGCCCGATACG -> CATTATCTGGCCCGATACGG
CCACTCCGTGTTTGCGGCAT -> CACTCCGTGTTTGCGGCATA
ATTTCGGTTGTTTGTTTTGT -> TTTCGGTTGTTTGTTTTGTG
CAAGTGGGGGTCTGTTAGAC -> AAGTGGGGGTCTGTTAGACT
CGTTGCGAATTAAGACCTGT -> GTTGCGAATTAAGACCTGTC
CCCAACACGGGAGTATTGCA -> CCAACACGGGAGTATTGCAG
TAAGTAAATGGCTAGACCGC -> AAGTAAATGGCTAGACCGCG
AACTGGGTGTTTTTAGTCAA -> ACTGGGTGTTTTTAGTCAAT
AACCCCTCCACTCCCATTGA -> ACCCCTCCACTCCCATTGAT
CATCCGCCATGTCAGTTGTC -> ATCCGCCATGTCAGTTGTCC
TGCTCAAGATATACTACGGA -> GCTCAAGATATACTACGGAA
TACGGAATCCCTTTGCACTC -> ACGGAATCCCTTTGCACTCG
GACTTTTGCAGCTGAATGGG -> ACTTTTGCAGCTGAATGGGT
TAGCTGTCAGTGCCTAGCCC -> AGCTGTCAGTGCCTAGCCCC
TCCCATTGATCCTTCCTTCG -> CCCATTGATCCTTCCTTCGG
GCTAGCTGTCAGTGCCTAGC -> CTAGCTGTCAGTGCCTAGCC
TGCCGAACCACTAGGACATC -> GCCGAACCACTAGGACATCA
ACTCGTCGCGTACTCTAGTC -> CTCGTCGCGTACTCTAGTCC
GGAACATCCTCGTCTTCGAC -> GAACATCCTCGTCTTCGACT
GATAGCTGCCTGCGAGATTA -> ATAGCTGCCTGCGAGATTAA
GAGATTAACGTTGGTAACCA -> AGATTAACGTTGGTAACCAG
CTGTATGAGGGCCTGGGACC -> TGTATGAGGGCCTGGGACCC
TCGTCGCGTACTCTAGTCCA -> CGTCGCGTACTCTAGTCCAG
CGTCTTCGACTGGCAATTTC -> GTCTTCGACTGGCAATTTCA
TCGTTGTGGAACCCTCGCGA -> CGTTGTGGAACCCTCGCGAT
TTGTGAGAAGCTTATATGTC -> TGTGAGAAGCTTATATGTCG
TTGCACTCGTGTTGGCGTCA -> TGCACTCGTGTTGGCGTCAT
TGTGCGCTCGTGAAGTTTTT -> GTGCGCTCGTGAAGTTTTTT
ACCGTTAGATGCCATCCGCC -> CCGTTAGATGCCATCCGCCA
GTTGGTCAGTCAGGCGGTGG -> TTGGTCAGTCAGGCGGTGGC
TTCGACTGGCAATTTCACCG -> TCGACTGGCAATTTCACCGT
AACTCGTTGATAGCTGCCTG -> ACTCGTTGATAGCTGCCTGC
TTTAGATACTTCAGCCATAG -> TTAGATACTTCAGCCATAGT
CTTTGCACTCGTGTTGGCGT -> TTTGCACTCGTGTTGGCGTC
TACGACTTTTGCAGCTGAAT -> ACGACTTTTGCAGCTGAATG
CCTCAACCGTAATCCACTCC -> CTCAACCGTAATCCACTCCG
ACCCAACACGGGAGTATTGC -> CCCAACACGGGAGTATTGCA
TAAATGGCTAGACCGCGCGT -> AAATGGCTAGACCGCGCGTC
CGTTGTGGAACCCTCGCGAT -> GTTGTGGAACCCTCGCGATT
GGACCCAGTGAATCCATAGT -> GACCCAGTGAATCCATAGTG
CATCCTCGTCTTCGACTGGC -> ATCCTCGTCTTCGACTGGCA
TACTACGGAATCCCTTTGCA -> ACTACGGAATCCCTTTGCAC
CGTGTTTGCGGCATAAACGT -> GTGTTTGCGGCATAAACGTT
AATTAAGACCTGTCGGCGTC -> ATTAAGACCTGTCGGCGTCT
ATGACTTGAAATAATCGTTG -> TGACTTGAAATAATCGTTGT
GAACATCCTCGTCTTCGACT -> AACATCCTCGTCTTCGACTG
AAATGCTCAAGATATACTAC -> AATGCTCAAGATATACTACG
CCGATACGGGTTTAATTCGC -> CGATACGGGTTTAATTCGCC
TCCACTCCCATTGATCCTTC -> CCACTCCCATTGATCCTTCC
ACAAATGACTCGTCGCGTAC -> CAAATGACTCGTCGCGTACT
TTTGTGAGAAGCTTATATGT -> TTGTGAGAAGCTTATATGTC
GACGCCTGGAGTACACTTCA -> ACGCCTGGAGTACACTTCAG
CGAACTGATGACTAAGTAAA -> GAACTGATGACTAAGTAAAT
CACTGTTCGTTGCGAATTAA -> ACTGTTCGTTGCGAATTAAG
CATAAGGAACATCCTCGTCT -> ATAAGGAACATCCTCGTCTT
GTGGCTAGCTGTCAGTGCCT -> TGGCTAGCTGTCAGTGCCTA
TTCGGTTGTTTGTTTTGTGA -> TCGGTTGTTTGTTTTGTGAG
GAGCGATTTAGATACTTCAG -> AGCGATTTAGATACTTCAGC
TTTCACCGTTAGATGCCATC -> TTCACCGTTAGATGCCATCC
CAAATGACTCGTCGCGTACT -> AAATGACTCGTCGCGTACTC
AGACCTGTCGGCGTCTTGGG -> GACCTGTCGGCGTCTTGGGC
ACTGATGACTAAGTAAATGG -> CTGATGACTAAGTAAATGGC
TCGACTGGCAATTTCACCGT -> CGACTGGCAATTTCACCGTT
TTAAGACCTGTCGGCGTCTT -> TAAGACCTGTCGGCGTCTTG
CGTCGCAAGTGGGGGTCTGT -> GTCGCAAGTGGGGGTCTGTT
GTTATAAACGAACTGATGAC -> TTATAAACGAACTGATGACT
GTGTGATGAGACAGATCTGG -> TGTGATGAGACAGATCTGGT
ACTTCAGCCATAGTGTTCCT -> CTTCAGCCATAGTGTTCCTC
TTCCGACCCAACACGGGAGT -> TCCGACCCAACACGGGAGTA
TAATCCACTCCGTGTTTGCG -> AATCCACTCCGTGTTTGCGG
TGGTAGCTAACTGGGTGTTT -> GGTAGCTAACTGGGTGTTTT
TTTGCAGCTGAATGGGTCAA -> TTGCAGCTGAATGGGTCAAA
CTCGTGTTGGCGTCATATGC -> TCGTGTTGGCGTCATATGCC
CCCTCCACTCCCATTGATCC -> CCTCCACTCCCATTGATCCT
CTCGCGATTTTCTAGATAGG -> TCGCGATTTTCTAGATAGGA
AGACAGATCTGGTAAAGTAT -> GACAGATCTGGTAAAGTATC
CTGGGACCCAGTGAATCCAT -> TGGGACCCAGTGAATCCATA
GTTGTCCAGTAGTTGTTGGG -> TTGTCCAGTAGTTGTTGGGC
TCACCGTTAGATGCCATCCG -> CACCGTTAGATGCCATCCGC
TGGTAACCAGGTAATCAATG -> GGTAACCAGGTAATCAATGT
AAAAACTATGACTTGAAATA -> AAAACTATGACTTGAAATAA
AGACTGGTAGCTAACTGGGT -> GACTGGTAGCTAACTGGGTG
ACATCCTCGTCTTCGACTGG -> CATCCTCGTCTTCGACTGGC
CATTGATCCTTCCTTCGGTT -> ATTGATCCTTCCTTCGGTTT
AATGTGCGCTCGTGAAGTTT -> ATGTGCGCTCGTGAAGTTTT
ACTTCAGGCAGGGCGTTATA -> CTTCAGGCAGGGCGTTATAA
ACCACCGTACGACTTTTGCA -> CCACCGTACGACTTTTGCAG
TTCCATTATCTGGCCCGATA -> TCCATTATCTGGCCCGATAC
TAGATGCCATCCGCCATGTC -> AGATGCCATCCGCCATGTCA
TGTTTTGTGAGAAGCTTATA -> GTTTTGTGAGAAGCTTATAT
GGGAACAAGGGTAGAACCCC -> GGAACAAGGGTAGAACCCCT
AGCGGATGGAAAATGCTCAA -> GCGGATGGAAAATGCTCAAG
GTATCATATCGTCGCAAGTG -> TATCATATCGTCGCAAGTGG
CGCCATAAGGAACATCCTCG -> GCCATAAGGAACATCCTCGT
ATCAGGACAAATGACTCGTC -> TCAGGACAAATGACTCGTCG
CTTTTGCAGCTGAATGGGTC -> TTTTGCAGCTGAATGGGTCA
GGCCCGATACGGGTTTAATT -> GCCCGATACGGGTTTAATTC
TTTTAGTCAATTTCGGTTGT -> TTTAGTCAATTTCGGTTGTT
CGTGTGATGAGACAGATCTG -> GTGTGATGAGACAGATCTGG
ATGAGGGCCTGGGACCCAGT -> TGAGGGCCTGGGACCCAGTG
CCTTTGCACTCGTGTTGGCG -> CTTTGCACTCGTGTTGGCGT
ATAATCGTTGTGGAACCCTC -> TAATCGTTGTGGAACCCTCG
GACTCGTCGCGTACTCTAGT -> ACTCGTCGCGTACTCTAGTC
TCACGCGGCAGCTATTTCTT -> CACGCGGCAGCTATTTCTTA
TTGTCCAGTAGTTGTTGGGC -> TGTCCAGTAGTTGTTGGGCG
CGTTTACATATATTCCGACC -> GTTTACATATATTCCGACCC
CCTCGCGATTTTCTAGATAG -> CTCGCGATTTTCTAGATAGG
TTGGGCGGAACCGTTGGTCA -> TGGGCGGAACCGTTGGTCAG
AACTGATGACTAAGTAAATG -> ACTGATGACTAAGTAAATGG
GTCATATGCCAGCACTGTTC -> TCATATGCCAGCACTGTTCG
CGATACGGGTTTAATTCGCC -> GATACGGGTTTAATTCGCCA
GCACTGTTCGTTGCGAATTA -> CACTGTTCGTTGCGAATTAA
TTAGCCTAGTAAAAACTATG -> TAGCCTAGTAAAAACTATGA
AACAAGGGTAGAACCCCTCC -> ACAAGGGTAGAACCCCTCCA
CTCAACCGTAATCCACTCCG -> TCAACCGTAATCCACTCCGT
TGGGGGTCTGTTAGACTGGT -> GGGGGTCTGTTAGACTGGTA
AGCTGCCTGCGAGATTAACG -> GCTGCCTGCGAGATTAACGT
TTTAGTCAATTTCGGTTGTT -> TTAGTCAATTTCGGTTGTTT
GATGGAAAATGCTCAAGATA -> ATGGAAAATGCTCAAGATAT
AAACGAACTGATGACTAAGT -> AACGAACTGATGACTAAGTA
TAGATAGGAGTGGGAACAAG -> AGATAGGAGTGGGAACAAGG
GACCTGTCGGCGTCTTGGGC -> ACCTGTCGGCGTCTTGGGCG
AAGTAAATGGCTAGACCGCG -> AGTAAATGGCTAGACCGCGC
TCCTCAACCGTAATCCACTC -> CCTCAACCGTAATCCACTCC
ACACAATTAACCACCGTACG -> CACAATTAACCACCGTACGA
AACTATGACTTGAAATAATC -> ACTATGACTTGAAATAATCG
GTGGGGGTCTGTTAGACTGG -> TGGGGGTCTGTTAGACTGGT
GTGTTTTTAGTCAATTTCGG -> TGTTTTTAGTCAATTTCGGT
GTTTAATTCGCCATAAGGAA -> TTTAATTCGCCATAAGGAAC
TCGGCGTCTTGGGCGTCATC -> CGGCGTCTTGGGCGTCATCC
CTCAAGATATACTACGGAAT -> TCAAGATATACTACGGAATC
CAGGCGGTGGCTAGCTGTCA -> AGGCGGTGGCTAGCTGTCAG
GTTGGGCGGAACCGTTGGTC -> TTGGGCGGAACCGTTGGTCA
CTACGGAATCCCTTTGCACT -> TACGGAATCCCTTTGCACTC
CGTACTCTAGTCCAGGATCG -> GTACTCTAGTCCAGGATCGG
GACTGGTAGCTAACTGGGTG -> ACTGGTAGCTAACTGGGTGT
ACGCTACCAATACTAAAGCC -> CGCTACCAATACTAAAGCCC
GTTGATAGCTGCCTGCGAGA -> TTGATAGCTGCCTGCGAGAT
GGTCTGTTAGACTGGTAGCT -> GTCTGTTAGACTGGTAGCTA
AAAACACAATTAACCACCGT -> AAACACAATTAACCACCGTA
GACCGCGCGTCCTCGTGTGA -> ACCGCGCGTCCTCGTGTGAT
CAGGATTCCATTATCTGGCC -> AGGATTCCATTATCTGGCCC
CCGCGCGTCCTCGTGTGATG -> CGCGCGTCCTCGTGTGATGA
AAACGTTTACATATATTCCG -> AACGTTTACATATATTCCGA
TGGTCAGTCAGGCGGTGGCT -> GGTCAGTCAGGCGGTGGCTA
CAACCGTAATCCACTCCGTG -> AACCGTAATCCACTCCGTGT
ATCCTTCCTTCGGTTTTGGC -> TCCTTCCTTCGGTTTTGGCG
TGCCTAGCCCCAAGGACGCC -> GCCTAGCCCCAAGGACGCCT
CGATTTTCTAGATAGGAGTG -> GATTTTCTAGATAGGAGTGG
AATTTCACCGTTAGATGCCA -> ATTTCACCGTTAGATGCCAT
GGTCAGTCAGGCGGTGGCTA -> GTCAGTCAGGCGGTGGCTAG
GTTTGCGGCATAAACGTTTA -> TTTGCGGCATAAACGTTTAC
TAACGTTGGTAACCAGGTAA -> AACGTTGGTAACCAGGTAAT
TCAGTTGTCCAGTAGTTGTT -> CAGTTGTCCAGTAGTTGTTG
AAGCTTATATGTCGGTGAGC -> AGCTTATATGTCGGTGAGCG
ACTCCGTGTTTGCGGCATAA -> CTCCGTGTTTGCGGCATAAA
CCTCTGTATGAGGGCCTGGG -> CTCTGTATGAGGGCCTGGGA
GGGCGGAACCGTTGGTCAGT -> GGCGGAACCGTTGGTCAGTC
CGAGATTAACGTTGGTAACC -> GAGATTAACGTTGGTAACCA
GAACTGATGACTAAGTAAAT -> AACTGATGACTAAGTAAATG
CGGCGTCTTGGGCGTCATCC -> GGCGTCTTGGGCGTCATCCT
CGCCATGTCAGTTGTCCAGT -> GCCATGTCAGTTGTCCAGTA
CCATAAGGAACATCCTCGTC -> CATAAGGAACATCCTCGTCT
TTATAACTCGTTGATAGCTG -> TATAACTCGTTGATAGCTGC
CCGTGTTTGCGGCATAAACG -> CGTGTTTGCGGCATAAACGT
ATCGTTGTGGAACCCTCGCG -> TCGTTGTGGAACCCTCGCGA
CCAGGTAATCAATGTGCGCT -> CAGGTAATCAATGTGCGCTC
TGGGCGTCATCCTCTGTATG -> GGGCGTCATCCTCTGTATGA
GACATCAGGACAAATGACTC -> ACATCAGGACAAATGACTCG
CGCTACCAATACTAAAGCCC -> GCTACCAATACTAAAGCCCG
GTGTTTGCGGCATAAACGTT -> TGTTTGCGGCATAAACGTTT
AAATGGCTAGACCGCGCGTC -> AATGGCTAGACCGCGCGTCC
TTTTATTTACAGAATGCTTA -> TTTATTTACAGAATGCTTAG
AGGAGTGGGAACAAGGGTAG -> GGAGTGGGAACAAGGGTAGA
TCTGGCCCGATACGGGTTTA -> CTGGCCCGATACGGGTTTAA
TGTTGGCGTCATATGCCAGC -> GTTGGCGTCATATGCCAGCA
CGGTTGTTTGTTTTGTGAGA -> GGTTGTTTGTTTTGTGAGAA
GTGAATCCATAGTGCCGAAC -> TGAATCCATAGTGCCGAACC
ATGGGTCAAAGCGGATGGAA -> TGGGTCAAAGCGGATGGAAA
CCGTACGACTTTTGCAGCTG -> CGTACGACTTTTGCAGCTGA
TTTTCTAGATAGGAGTGGGA -> TTTCTAGATAGGAGTGGGAA
TTTTTAGTCAATTTCGGTTG -> TTTTAGTCAATTTCGGTTGT
GCAGCTATTTCTTATAACTC -> CAGCTATTTCTTATAACTCG
AGGGTAGAACCCCTCCACTC -> GGGTAGAACCCCTCCACTCC
CGGTGAGCGATTTAGATACT -> GGTGAGCGATTTAGATACTT
GTTGGCGTCATATGCCAGCA -> TTGGCGTCATATGCCAGCAC
ACTATGACTTGAAATAATCG -> CTATGACTTGAAATAATCGT
CCTGTCGGCGTCTTGGGCGT -> CTGTCGGCGTCTTGGGCGTC
AATAATCGTTGTGGAACCCT -> ATAATCGTTGTGGAACCCTC
CAGCTGAATGGGTCAAAGCG -> AGCTGAATGGGTCAAAGCGG
AGGGCGTTATAAACGAACTG -> GGGCGTTATAAACGAACTGA
GCTGTCAGTGCCTAGCCCCA -> CTGTCAGTGCCTAGCCCCAA
ACCTGTCGGCGTCTTGGGCG -> CCTGTCGGCGTCTTGGGCGT
GTTAGACTGGTAGCTAACTG -> TTAGACTGGTAGCTAACTGG
CCATCCGCCATGTCAGTTGT -> CATCCGCCATGTCAGTTGTC
TTCCTTCGGTTTTGGCGCCA -> TCCTTCGGTTTTGGCGCCAG
TCGTGTGATGAGACAGATCT -> CGTGTGATGAGACAGATCTG
GCCGAACCACTAGGACATCA -> CCGAACCACTAGGACATCAG
CTGGAGTACACTTCAGGCAG -> TGGAGTACACTTCAGGCAGG
TTTACAGAATGCTTAGCCTA -> TTACAGAATGCTTAGCCTAG
ATAACTCGTTGATAGCTGCC -> TAACTCGTTGATAGCTGCCT
CAAGGACGCCTGGAGTACAC -> AAGGACGCCTGGAGTACACT
GTTTTTAGTCAATTTCGGTT -> TTTTTAGTCAATTTCGGTTG
TATCGTCGCAAGTGGGGGTC -> ATCGTCGCAAGTGGGGGTCT
GGCAATTTCACCGTTAGATG -> GCAATTTCACCGTTAGATGC
GTAAAAACTATGACTTGAAA -> TAAAAACTATGACTTGAAAT
GCGATTTAGATACTTCAGCC -> CGATTTAGATACTTCAGCCA
AGTCAATTTCGGTTGTTTGT -> GTCAATTTCGGTTGTTTGTT
CGTCATATGCCAGCACTGTT -> GTCATATGCCAGCACTGTTC
TAACTCGTTGATAGCTGCCT -> AACTCGTTGATAGCTGCCTG
ATGTCAGTTGTCCAGTAGTT -> TGTCAGTTGTCCAGTAGTTG
CGACTTTTGCAGCTGAATGG -> GACTTTTGCAGCTGAATGGG
TGCCTGCGAGATTAACGTTG -> GCCTGCGAGATTAACGTTGG
GACTAAGTAAATGGCTAGAC -> ACTAAGTAAATGGCTAGACC
TGGAACCCTCGCGATTTTCT -> GGAACCCTCGCGATTTTCTA
CACTCGTGTTGGCGTCATAT -> ACTCGTGTTGGCGTCATATG
GTTGCGAATTAAGACCTGTC -> TTGCGAATTAAGACCTGTCG
GTACTCTAGTCCAGGATCGG -> TACTCTAGTCCAGGATCGGA
CGTCGCGTACTCTAGTCCAG -> GTCGCGTACTCTAGTCCAGG
GGGTGTTTTTAGTCAATTTC -> GGTGTTTTTAGTCAATTTCG
GTTAGATGCCATCCGCCATG -> TTAGATGCCATCCGCCATGT
GAAATAATCGTTGTGGAACC -> AAATAATCGTTGTGGAACCC
AGCTAACTGGGTGTTTTTAG -> GCTAACTGGGTGTTTTTAGT
GCGGAACCGTTGGTCAGTCA -> CGGAACCGTTGGTCAGTCAG
TGGAAAATGCTCAAGATATA -> GGAAAATGCTCAAGATATAC
GTTTTGTGAGAAGCTTATAT -> TTTTGTGAGAAGCTTATATG
CAATGTGCGCTCGTGAAGTT -> AATGTGCGCTCGTGAAGTTT
TGCGCTCGTGAAGTTTTTTA -> GCGCTCGTGAAGTTTTTTAT
TTTCTAGATAGGAGTGGGAA -> TTCTAGATAGGAGTGGGAAC
AAAGCCCGTGCATCACGCGG -> AAGCCCGTGCATCACGCGGC
GGTTGTTTGTTTTGTGAGAA -> GTTGTTTGTTTTGTGAGAAG
TCGTGTTGGCGTCATATGCC -> CGTGTTGGCGTCATATGCCA
ATCCTCGTCTTCGACTGGCA -> TCCTCGTCTTCGACTGGCAA
AAGATATACTACGGAATCCC -> AGATATACTACGGAATCCCT
ATGCCAGCACTGTTCGTTGC -> TGCCAGCACTGTTCGTTGCG
ATCCCTTTGCACTCGTGTTG -> TCCCTTTGCACTCGTGTTGG
GGTCAAAGCGGATGGAAAAT -> GTCAAAGCGGATGGAAAATG
ATGTCGGTGAGCGATTTAGA -> TGTCGGTGAGCGATTTAGAT
AGTAAATGGCTAGACCGCGC -> GTAAATGGCTAGACCGCGCG
CTGGGTGTTTTTAGTCAATT -> TGGGTGTTTTTAGTCAATTT
GATTTAGATACTTCAGCCAT -> ATTTAGATACTTCAGCCATA
TAGGACATCAGGACAAATGA -> AGGACATCAGGACAAATGAC
TGATCCTTCCTTCGGTTTTG -> GATCCTTCCTTCGGTTTTGG
CAAAGCGGATGGAAAATGCT -> AAAGCGGATGGAAAATGCTC
GTCTGTTAGACTGGTAGCTA -> TCTGTTAGACTGGTAGCTAA
GAACCCTCGCGATTTTCTAG -> AACCCTCGCGATTTTCTAGA
GAGACAGATCTGGTAAAGTA -> AGACAGATCTGGTAAAGTAT
GTCGGCGTCTTGGGCGTCAT -> TCGGCGTCTTGGGCGTCATC
CATAGTGCCGAACCACTAGG -> ATAGTGCCGAACCACTAGGA
AGCGATTTAGATACTTCAGC -> GCGATTTAGATACTTCAGCC
TGTCAGTTGTCCAGTAGTTG -> GTCAGTTGTCCAGTAGTTGT
AGGACATCAGGACAAATGAC -> GGACATCAGGACAAATGACT
TCGGTTGTTTGTTTTGTGAG -> CGGTTGTTTGTTTTGTGAGA
TCGCGTACTCTAGTCCAGGA -> CGCGTACTCTAGTCCAGGAT
GTTCGTTGCGAATTAAGACC -> TTCGTTGCGAATTAAGACCT
GTCAGTTGTCCAGTAGTTGT -> TCAGTTGTCCAGTAGTTGTT
GGACGCCTGGAGTACACTTC -> GACGCCTGGAGTACACTTCA
CTAGCCCCAAGGACGCCTGG -> TAGCCCCAAGGACGCCTGGA
TCCAGTAGTTGTTGGGCGGA -> CCAGTAGTTGTTGGGCGGAA
ACGCGGCAGCTATTTCTTAT -> CGCGGCAGCTATTTCTTATA
TAAACGAACTGATGACTAAG -> AAACGAACTGATGACTAAGT
TTTACATATATTCCGACCCA -> TTACATATATTCCGACCCAA
TATTGCAGGTTGTAAAACAC -> ATTGCAGGTTGTAAAACACA
ATGCTTAGCCTAGTAAAAAC -> TGCTTAGCCTAGTAAAAACT
ATCCTCTGTATGAGGGCCTG -> TCCTCTGTATGAGGGCCTGG
TCTAGATAGGAGTGGGAACA -> CTAGATAGGAGTGGGAACAA
GTAGCTAACTGGGTGTTTTT -> TAGCTAACTGGGTGTTTTTA
AAAACTATGACTTGAAATAA -> AAACTATGACTTGAAATAAT
CAGTCAGGCGGTGGCTAGCT -> AGTCAGGCGGTGGCTAGCTG
TTGTTTGTTTTGTGAGAAGC -> TGTTTGTTTTGTGAGAAGCT
GCCATAAGGAACATCCTCGT -> CCATAAGGAACATCCTCGTC
AAGCGGATGGAAAATGCTCA -> AGCGGATGGAAAATGCTCAA
GTCATCCTCTGTATGAGGGC -> TCATCCTCTGTATGAGGGCC
GCGCGTCCTCGTGTGATGAG -> CGCGTCCTCGTGTGATGAGA
TGCAGGTTGTAAAACACAAT -> GCAGGTTGTAAAACACAATT
TGCGAATTAAGACCTGTCGG -> GCGAATTAAGACCTGTCGGC
CTGGCCCGATACGGGTTTAA -> TGGCCCGATACGGGTTTAAT
CCCGTGCATCACGCGGCAGC -> CCGTGCATCACGCGGCAGCT
CATAAACGTTTACATATATT -> ATAAACGTTTACATATATTC
ATACTAAAGCCCGTGCATCA -> TACTAAAGCCCGTGCATCAC
GGCGCCAGGATTCCATTATC -> GCGCCAGGATTCCATTATCT
TGAATCCATAGTGCCGAACC -> GAATCCATAGTGCCGAACCA
CCTGCGAGATTAACGTTGGT -> CTGCGAGATTAACGTTGGTA
TTTTTTATTTACAGAATGCT -> TTTTTATTTACAGAATGCTT
TCAATGTGCGCTCGTGAAGT -> CAATGTGCGCTCGTGAAGTT
CTAACTGGGTGTTTTTAGTC -> TAACTGGGTGTTTTTAGTCA
ACGGGTTTAATTCGCCATAA -> CGGGTTTAATTCGCCATAAG
CGTGAAGTTTTTTATTTACA -> GTGAAGTTTTTTATTTACAG
GTCTTCGACTGGCAATTTCA -> TCTTCGACTGGCAATTTCAC
ATTAAGACCTGTCGGCGTCT -> TTAAGACCTGTCGGCGTCTT
TTGAAATAATCGTTGTGGAA -> TGAAATAATCGTTGTGGAAC
CAGTGCCTAGCCCCAAGGAC -> AGTGCCTAGCCCCAAGGACG
CTTCGACTGGCAATTTCACC -> TTCGACTGGCAATTTCACCG
GAGTGGGAACAAGGGTAGAA -> AGTGGGAACAAGGGTAGAAC
ACCCCTCCACTCCCATTGAT -> CCCCTCCACTCCCATTGATC
GTCAGTCAGGCGGTGGCTAG -> TCAGTCAGGCGGTGGCTAGC
AGTTGTTGGGCGGAACCGTT -> GTTGTTGGGCGGAACCGTTG
ATAGCTGCCTGCGAGATTAA -> TAGCTGCCTGCGAGATTAAC
ATAAACGAACTGATGACTAA -> TAAACGAACTGATGACTAAG
CAGCCATAGTGTTCCTCAAC -> AGCCATAGTGTTCCTCAACC
TCAGGCGGTGGCTAGCTGTC -> CAGGCGGTGGCTAGCTGTCA
CCAACACGGGAGTATTGCAG -> CAACACGGGAGTATTGCAGG
CGTAATCCACTCCGTGTTTG -> GTAATCCACTCCGTGTTTGC
TTGATCCTTCCTTCGGTTTT -> TGATCCTTCCTTCGGTTTTG
TCCTCGTCTTCGACTGGCAA -> CCTCGTCTTCGACTGGCAAT
GCTGAATGGGTCAAAGCGGA -> CTGAATGGGTCAAAGCGGAT
GGAGTATTGCAGGTTGTAAA -> GAGTATTGCAGGTTGTAAAA
TGGCTAGACCGCGCGTCCTC -> GGCTAGACCGCGCGTCCTCG
TGATGACTAAGTAAATGGCT -> GATGACTAAGTAAATGGCTA
CAATTTCGGTTGTTTGTTTT -> AATTTCGGTTGTTTGTTTTG
GTGCATCACGCGGCAGCTAT -> TGCATCACGCGGCAGCTATT
ATTTTCTAGATAGGAGTGGG -> TTTTCTAGATAGGAGTGGGA
GCGAGATTAACGTTGGTAAC -> CGAGATTAACGTTGGTAACC
CGGCATAAACGTTTACATAT -> GGCATAAACGTTTACATATA
GACTGGCAATTTCACCGTTA -> ACTGGCAATTTCACCGTTAG
TAATCGTTGTGGAACCCTCG -> AATCGTTGTGGAACCCTCGC
CACGCTACCAATACTAAAGC -> ACGCTACCAATACTAAAGCC
CAGGCAGGGCGTTATAAACG -> AGGCAGGGCGTTATAAACGA
GTAACCAGGTAATCAATGTG -> TAACCAGGTAATCAATGTGC
AAGCCCGTGCATCACGCGGC -> AGCCCGTGCATCACGCGGCA
TATTTCTTATAACTCGTTGA -> ATTTCTTATAACTCGTTGAT
TATATGTCGGTGAGCGATTT -> ATATGTCGGTGAGCGATTTA
AGGATTCCATTATCTGGCCC -> GGATTCCATTATCTGGCCCG
GTCCTCGTGTGATGAGACAG -> TCCTCGTGTGATGAGACAGA
CAGGGCGTTATAAACGAACT -> AGGGCGTTATAAACGAACTG
GAGGGCCTGGGACCCAGTGA -> AGGGCCTGGGACCCAGTGAA
GCCATGTCAGTTGTCCAGTA -> CCATGTCAGTTGTCCAGTAG
AGTATCATATCGTCGCAAGT -> GTATCATATCGTCGCAAGTG
GTCAAAGCGGATGGAAAATG -> TCAAAGCGGATGGAAAATGC
GTTTTTTATTTACAGAATGC -> TTTTTTATTTACAGAATGCT
GATCTGGTAAAGTATCATAT -> ATCTGGTAAAGTATCATATC
GGCCTGGGACCCAGTGAATC -> GCCTGGGACCCAGTGAATCC
TTAGTCAATTTCGGTTGTTT -> TAGTCAATTTCGGTTGTTTG
CCGTTAGATGCCATCCGCCA -> CGTTAGATGCCATCCGCCAT
CTTCAGGCAGGGCGTTATAA -> TTCAGGCAGGGCGTTATAAA
TTCGCCATAAGGAACATCCT -> TCGCCATAAGGAACATCCTC
TAGTGCCGAACCACTAGGAC -> AGTGCCGAACCACTAGGACA
GCGCCAGGATTCCATTATCT -> CGCCAGGATTCCATTATCTG
TCAAGATATACTACGGAATC -> CAAGATATACTACGGAATCC
CTCGTCTTCGACTGGCAATT -> TCGTCTTCGACTGGCAATTT
ATTCGCCATAAGGAACATCC -> TTCGCCATAAGGAACATCCT
AACGTTGGTAACCAGGTAAT -> ACGTTGGTAACCAGGTAATC
CTTCGGTTTTGGCGCCAGGA -> TTCGGTTTTGGCGCCAGGAT
TACGGGTTTAATTCGCCATA -> ACGGGTTTAATTCGCCATAA
AGAAGCTTATATGTCGGTGA -> GAAGCTTATATGTCGGTGAG
AGATCTGGTAAAGTATCATA -> GATCTGGTAAAGTATCATAT
GGCGTCATATGCCAGCACTG -> GCGTCATATGCCAGCACTGT
TAGTCAATTTCGGTTGTTTG -> AGTCAATTTCGGTTGTTTGT
TCCTCGTGTGATGAGACAGA -> CCTCGTGTGATGAGACAGAT
TCGGTGAGCGATTTAGATAC -> CGGTGAGCGATTTAGATACT
TGGCGCCAGGATTCCATTAT -> GGCGCCAGGATTCCATTATC
CGTACGACTTTTGCAGCTGA -> GTACGACTTTTGCAGCTGAA
TTAACGTTGGTAACCAGGTA -> TAACGTTGGTAACCAGGTAA
CCTGGGACCCAGTGAATCCA -> CTGGGACCCAGTGAATCCAT
CGTGTTGGCGTCATATGCCA -> GTGTTGGCGTCATATGCCAG
ACTGTTCGTTGCGAATTAAG -> CTGTTCGTTGCGAATTAAGA
CTCGTCGCGTACTCTAGTCC -> TCGTCGCGTACTCTAGTCCA
GCGATTTTCTAGATAGGAGT -> CGATTTTCTAGATAGGAGTG
GATGAGACAGATCTGGTAAA -> ATGAGACAGATCTGGTAAAG
AGAACCCCTCCACTCCCATT -> GAACCCCTCCACTCCCATTG
GAACCCCTCCACTCCCATTG -> AACCCCTCCACTCCCATTGA
ATATCGTCGCAAGTGGGGGT -> TATCGTCGCAAGTGGGGGTC
CTTGAAATAATCGTTGTGGA -> TTGAAATAATCGTTGTGGAA
TAGATACTTCAGCCATAGTG -> AGATACTTCAGCCATAGTGT
AGCTATTTCTTATAACTCGT -> GCTATTTCTTATAACTCGTT
TTAGATACTTCAGCCATAGT -> TAGATACTTCAGCCATAGTG
ACAAGGGTAGAACCCCTCCA -> CAAGGGTAGAACCCCTCCAC
CCTCGTGTGATGAGACAGAT -> CTCGTGTGATGAGACAGATC
AAACACAATTAACCACCGTA -> AACACAATTAACCACCGTAC
GCCTAGTAAAAACTATGACT -> CCTAGTAAAAACTATGACTT
GATACGGGTTTAATTCGCCA -> ATACGGGTTTAATTCGCCAT
ACGGAATCCCTTTGCACTCG -> CGGAATCCCTTTGCACTCGT
GATCCTTCCTTCGGTTTTGG -> ATCCTTCCTTCGGTTTTGGC
ATGAGACAGATCTGGTAAAG -> TGAGACAGATCTGGTAAAGT
GCTCAAGATATACTACGGAA -> CTCAAGATATACTACGGAAT
TGATAGCTGCCTGCGAGATT -> GATAGCTGCCTGCGAGATTA
ATTTACAGAATGCTTAGCCT -> TTTACAGAATGCTTAGCCTA
ATCTGGTAAAGTATCATATC -> TCTGGTAAAGTATCATATCG
GGTAGAACCCCTCCACTCCC -> GTAGAACCCCTCCACTCCCA
ACTCCCATTGATCCTTCCTT -> CTCCCATTGATCCTTCCTTC
ATGCTCAAGATATACTACGG -> TGCTCAAGATATACTACGGA
TCCGCCATGTCAGTTGTCCA -> CCGCCATGTCAGTTGTCCAG
TGGGAACAAGGGTAGAACCC -> GGGAACAAGGGTAGAACCCC
ATGGAAAATGCTCAAGATAT -> TGGAAAATGCTCAAGATATA
CGTGCATCACGCGGCAGCTA -> GTGCATCACGCGGCAGCTAT
AGTACACTTCAGGCAGGGCG -> GTACACTTCAGGCAGGGCGT
TTAGACTGGTAGCTAACTGG -> TAGACTGGTAGCTAACTGGG
CAGGACAAATGACTCGTCGC -> AGGACAAATGACTCGTCGCG
GTATTGCAGGTTGTAAAACA -> TATTGCAGGTTGTAAAACAC
TGTCGGTGAGCGATTTAGAT -> GTCGGTGAGCGATTTAGATA
GGGACCCAGTGAATCCATAG -> GGACCCAGTGAATCCATAGT
CTGTTAGACTGGTAGCTAAC -> TGTTAGACTGGTAGCTAACT
GCTAACTGGGTGTTTTTAGT -> CTAACTGGGTGTTTTTAGTC
TCGTCTTCGACTGGCAATTT -> CGTCTTCGACTGGCAATTTC
TTCTTATAACTCGTTGATAG -> TCTTATAACTCGTTGATAGC
ATTATCTGGCCCGATACGGG -> TTATCTGGCCCGATACGGGT
TCATCCTCTGTATGAGGGCC -> CATCCTCTGTATGAGGGCCT
ACTCGTGTTGGCGTCATATG -> CTCGTGTTGGCGTCATATGC
GTCCAGGATCGGAACGACCT -> TCCAGGATCGGAACGACCTT
CACTTCAGGCAGGGCGTTAT -> ACTTCAGGCAGGGCGTTATA
TCTAGTCCAGGATCGGAACG -> CTAGTCCAGGATCGGAACGA
ATTAACCACCGTACGACTTT -> TTAACCACCGTACGACTTTT
TCGTGAAGTTTTTTATTTAC -> CGTGAAGTTTTTTATTTACA
AAGGAACATCCTCGTCTTCG -> AGGAACATCCTCGTCTTCGA
AGATAGGAGTGGGAACAAGG -> GATAGGAGTGGGAACAAGGG
AGCTGAATGGGTCAAAGCGG -> GCTGAATGGGTCAAAGCGGA
CGGGAGTATTGCAGGTTGTA -> GGGAGTATTGCAGGTTGTAA
GAGTATTGCAGGTTGTAAAA -> AGTATTGCAGGTTGTAAAAC
ATAGTGCCGAACCACTAGGA -> TAGTGCCGAACCACTAGGAC
TGTGGAACCCTCGCGATTTT -> GTGGAACCCTCGCGATTTTC
GCGGTGGCTAGCTGTCAGTG -> CGGTGGCTAGCTGTCAGTGC
GTGAGCGATTTAGATACTTC -> TGAGCGATTTAGATACTTCA
AACGTTTACATATATTCCGA -> ACGTTTACATATATTCCGAC
CCCATTGATCCTTCCTTCGG -> CCATTGATCCTTCCTTCGGT
AGGCGGTGGCTAGCTGTCAG -> GGCGGTGGCTAGCTGTCAGT
GCGTACTCTAGTCCAGGATC -> CGTACTCTAGTCCAGGATCG
TTAATTCGCCATAAGGAACA -> TAATTCGCCATAAGGAACAT
CTGTCGGCGTCTTGGGCGTC -> TGTCGGCGTCTTGGGCGTCA
CATATATTCCGACCCAACAC -> ATATATTCCGACCCAACACG
CTAGACCGCGCGTCCTCGTG -> TAGACCGCGCGTCCTCGTGT
AGTCAGGCGGTGGCTAGCTG -> GTCAGGCGGTGGCTAGCTGT
GGAGTACACTTCAGGCAGGG -> GAGTACACTTCAGGCAGGGC
ACAGATCTGGTAAAGTATCA -> CAGATCTGGTAAAGTATCAT
TCCTTCGGTTTTGGCGCCAG -> CCTTCGGTTTTGGCGCCAGG
CTATGACTTGAAATAATCGT -> TATGACTTGAAATAATCGTT
GATAGGAGTGGGAACAAGGG -> ATAGGAGTGGGAACAAGGGT
AAGTATCATATCGTCGCAAG -> AGTATCATATCGTCGCAAGT
TGAGCGATTTAGATACTTCA -> GAGCGATTTAGATACTTCAG
AGTGGGAACAAGGGTAGAAC -> GTGGGAACAAGGGTAGAACC
TGTTAGACTGGTAGCTAACT -> GTTAGACTGGTAGCTAACTG
CCGTGCATCACGCGGCAGCT -> CGTGCATCACGCGGCAGCTA
CCATGTCAGTTGTCCAGTAG -> CATGTCAGTTGTCCAGTAGT
TTAGATGCCATCCGCCATGT -> TAGATGCCATCCGCCATGTC
ACTGGGTGTTTTTAGTCAAT -> CTGGGTGTTTTTAGTCAATT
CTGGTAGCTAACTGGGTGTT -> TGGTAGCTAACTGGGTGTTT
TATAACTCGTTGATAGCTGC -> ATAACTCGTTGATAGCTGCC
GGAAAATGCTCAAGATATAC -> GAAAATGCTCAAGATATACT
GAGAAGCTTATATGTCGGTG -> AGAAGCTTATATGTCGGTGA
AGATGCCATCCGCCATGTCA -> GATGCCATCCGCCATGTCAG
CTGCGAGATTAACGTTGGTA -> TGCGAGATTAACGTTGGTAA
TAACCAGGTAATCAATGTGC -> AACCAGGTAATCAATGTGCG
GTAAATGGCTAGACCGCGCG -> TAAATGGCTAGACCGCGCGT
ATGGCTAGACCGCGCGTCCT -> TGGCTAGACCGCGCGTCCTC
GGCGTCATCCTCTGTATGAG -> GCGTCATCCTCTGTATGAGG
ATATTCCGACCCAACACGGG -> TATTCCGACCCAACACGGGA
GTTTACATATATTCCGACCC -> TTTACATATATTCCGACCCA
AACCAGGTAATCAATGTGCG -> ACCAGGTAATCAATGTGCGC
ACGAACTGATGACTAAGTAA -> CGAACTGATGACTAAGTAAA
AACCACTAGGACATCAGGAC -> ACCACTAGGACATCAGGACA
CCTAGCCCCAAGGACGCCTG -> CTAGCCCCAAGGACGCCTGG
TATTTACAGAATGCTTAGCC -> ATTTACAGAATGCTTAGCCT
GGTAATCAATGTGCGCTCGT -> GTAATCAATGTGCGCTCGTG
TCTTATAACTCGTTGATAGC -> CTTATAACTCGTTGATAGCT
TTTTGGCGCCAGGATTCCAT -> TTTGGCGCCAGGATTCCATT
CACGCGGCAGCTATTTCTTA -> ACGCGGCAGCTATTTCTTAT
AGTTTTTTATTTACAGAATG -> GTTTTTTATTTACAGAATGC
GGCGGAACCGTTGGTCAGTC -> GCGGAACCGTTGGTCAGTCA
GAGTACACTTCAGGCAGGGC -> AGTACACTTCAGGCAGGGCG
TCCTTCCTTCGGTTTTGGCG -> CCTTCCTTCGGTTTTGGCGC
TTCGTTGCGAATTAAGACCT -> TCGTTGCGAATTAAGACCTG
GAATCCATAGTGCCGAACCA -> AATCCATAGTGCCGAACCAC
CTGGTAAAGTATCATATCGT -> TGGTAAAGTATCATATCGTC
ATAGTGTTCCTCAACCGTAA -> TAGTGTTCCTCAACCGTAAT
ATCCACTCCGTGTTTGCGGC -> TCCACTCCGTGTTTGCGGCA
GGAACCCTCGCGATTTTCTA -> GAACCCTCGCGATTTTCTAG
GTTGTGGAACCCTCGCGATT -> TTGTGGAACCCTCGCGATTT
TAGTTGTTGGGCGGAACCGT -> AGTTGTTGGGCGGAACCGTT
CACTAGGACATCAGGACAAA -> ACTAGGACATCAGGACAAAT
ATAAGGAACATCCTCGTCTT -> TAAGGAACATCCTCGTCTTC
AGGCAGGGCGTTATAAACGA -> GGCAGGGCGTTATAAACGAA
GGATGGAAAATGCTCAAGAT -> GATGGAAAATGCTCAAGATA
GCGTCATATGCCAGCACTGT -> CGTCATATGCCAGCACTGTT
CCAATACTAAAGCCCGTGCA -> CAATACTAAAGCCCGTGCAT
GGCATAAACGTTTACATATA -> GCATAAACGTTTACATATAT
TTTCTTATAACTCGTTGATA -> TTCTTATAACTCGTTGATAG
TAGTGTTCCTCAACCGTAAT -> AGTGTTCCTCAACCGTAATC
GCGTCATCCTCTGTATGAGG -> CGTCATCCTCTGTATGAGGG
GTATGAGGGCCTGGGACCCA -> TATGAGGGCCTGGGACCCAG
GGGGGTCTGTTAGACTGGTA -> GGGGTCTGTTAGACTGGTAG
CCCTCGCGATTTTCTAGATA -> CCTCGCGATTTTCTAGATAG
GGCGGTGGCTAGCTGTCAGT -> GCGGTGGCTAGCTGTCAGTG
TTGCAGCTGAATGGGTCAAA -> TGCAGCTGAATGGGTCAAAG
CAATTAACCACCGTACGACT -> AATTAACCACCGTACGACTT
TGCCAGCACTGTTCGTTGCG -> GCCAGCACTGTTCGTTGCGA
TGAAATAATCGTTGTGGAAC -> GAAATAATCGTTGTGGAACC
AGCCTAGTAAAAACTATGAC -> GCCTAGTAAAAACTATGACT
CTAGCTGTCAGTGCCTAGCC -> TAGCTGTCAGTGCCTAGCCC
TGTTGGGCGGAACCGTTGGT -> GTTGGGCGGAACCGTTGGTC
TCTGTATGAGGGCCTGGGAC -> CTGTATGAGGGCCTGGGACC
TGTTTGCGGCATAAACGTTT -> GTTTGCGGCATAAACGTTTA
TCCTCTGTATGAGGGCCTGG -> CCTCTGTATGAGGGCCTGGG
TGGGACCCAGTGAATCCATA -> GGGACCCAGTGAATCCATAG
AATGGGTCAAAGCGGATGGA -> ATGGGTCAAAGCGGATGGAA
ACAATTAACCACCGTACGAC -> CAATTAACCACCGTACGACT
TATGACTTGAAATAATCGTT -> ATGACTTGAAATAATCGTTG
TCAGCCATAGTGTTCCTCAA -> CAGCCATAGTGTTCCTCAAC
GTGGAACCCTCGCGATTTTC -> TGGAACCCTCGCGATTTTCT
TTTTTATTTACAGAATGCTT -> TTTTATTTACAGAATGCTTA
TACTTCAGCCATAGTGTTCC -> ACTTCAGCCATAGTGTTCCT
TTGTAAAACACAATTAACCA -> TGTAAAACACAATTAACCAC
AAGTGGGGGTCTGTTAGACT -> AGTGGGGGTCTGTTAGACTG
TAGAACCCCTCCACTCCCAT -> AGAACCCCTCCACTCCCATT
TAACTGGGTGTTTTTAGTCA -> AACTGGGTGTTTTTAGTCAA
GTCGCAAGTGGGGGTCTGTT -> TCGCAAGTGGGGGTCTGTTA
TTTTGCAGCTGAATGGGTCA -> TTTGCAGCTGAATGGGTCAA
CCGACCCAACACGGGAGTAT -> CGACCCAACACGGGAGTATT
ACCGCGCGTCCTCGTGTGAT -> CCGCGCGTCCTCGTGTGATG
CTATTTCTTATAACTCGTTG -> TATTTCTTATAACTCGTTGA
GTTTGTTTTGTGAGAAGCTT -> TTTGTTTTGTGAGAAGCTTA
CCCCAAGGACGCCTGGAGTA -> CCCAAGGACGCCTGGAGTAC
TGGTAAAGTATCATATCGTC -> GGTAAAGTATCATATCGTCG
GGTGGCTAGCTGTCAGTGCC -> GTGGCTAGCTGTCAGTGCCT
GTTGTAAAACACAATTAACC -> TTGTAAAACACAATTAACCA
ACCACTAGGACATCAGGACA -> CCACTAGGACATCAGGACAA
TTTGTTTTGTGAGAAGCTTA -> TTGTTTTGTGAGAAGCTTAT
CCCCTCCACTCCCATTGATC -> CCCTCCACTCCCATTGATCC
CCCTTTGCACTCGTGTTGGC -> CCTTTGCACTCGTGTTGGCG
CGGTTTTGGCGCCAGGATTC -> GGTTTTGGCGCCAGGATTCC
GGGTTTAATTCGCCATAAGG -> GGTTTAATTCGCCATAAGGA
AAGTTTTTTATTTACAGAAT -> AGTTTTTTATTTACAGAATG
CCGTTGGTCAGTCAGGCGGT -> CGTTGGTCAGTCAGGCGGTG
TCGCCATAAGGAACATCCTC -> CGCCATAAGGAACATCCTCG
AAGACCTGTCGGCGTCTTGG -> AGACCTGTCGGCGTCTTGGG
GGTAAAGTATCATATCGTCG -> GTAAAGTATCATATCGTCGC
GAACCACTAGGACATCAGGA -> AACCACTAGGACATCAGGAC
TTAACCACCGTACGACTTTT -> TAACCACCGTACGACTTTTG
GCCCCAAGGACGCCTGGAGT -> CCCCAAGGACGCCTGGAGTA
AGGGCCTGGGACCCAGTGAA -> GGGCCTGGGACCCAGTGAAT
GTAGAACCCCTCCACTCCCA -> TAGAACCCCTCCACTCCCAT
TACCAATACTAAAGCCCGTG -> ACCAATACTAAAGCCCGTGC
GTTCCTCAACCGTAATCCAC -> TTCCTCAACCGTAATCCACT
AGTTGTCCAGTAGTTGTTGG -> GTTGTCCAGTAGTTGTTGGG
CCTTCCTTCGGTTTTGGCGC -> CTTCCTTCGGTTTTGGCGCC
AATCCACTCCGTGTTTGCGG -> ATCCACTCCGTGTTTGCGGC
AACCCTCGCGATTTTCTAGA -> ACCCTCGCGATTTTCTAGAT
CGCGGCAGCTATTTCTTATA -> GCGGCAGCTATTTCTTATAA
GGTGTTTTTAGTCAATTTCG -> GTGTTTTTAGTCAATTTCGG
GGACAAATGACTCGTCGCGT -> GACAAATGACTCGTCGCGTA
TCCCTTTGCACTCGTGTTGG -> CCCTTTGCACTCGTGTTGGC
CGTTGGTAACCAGGTAATCA -> GTTGGTAACCAGGTAATCAA
AACCGTTGGTCAGTCAGGCG -> ACCGTTGGTCAGTCAGGCGG
AATGACTCGTCGCGTACTCT -> ATGACTCGTCGCGTACTCTA
CGACTGGCAATTTCACCGTT -> GACTGGCAATTTCACCGTTA
GCCAGGATTCCATTATCTGG -> CCAGGATTCCATTATCTGGC
ACGGGAGTATTGCAGGTTGT -> CGGGAGTATTGCAGGTTGTA
AGGACGCCTGGAGTACACTT -> GGACGCCTGGAGTACACTTC
GAAGCTTATATGTCGGTGAG -> AAGCTTATATGTCGGTGAGC
ATTGCAGGTTGTAAAACACA -> TTGCAGGTTGTAAAACACAA
ATTTCACCGTTAGATGCCAT -> TTTCACCGTTAGATGCCATC
ACCAGGTAATCAATGTGCGC -> CCAGGTAATCAATGTGCGCT
ACACGGGAGTATTGCAGGTT -> CACGGGAGTATTGCAGGTTG
CCCAGTGAATCCATAGTGCC -> CCAGTGAATCCATAGTGCCG
GGGAGTATTGCAGGTTGTAA -> GGAGTATTGCAGGTTGTAAA
TTCCTCAACCGTAATCCACT -> TCCTCAACCGTAATCCACTC
AGCTGTCAGTGCCTAGCCCC -> GCTGTCAGTGCCTAGCCCCA
AATGGCTAGACCGCGCGTCC -> ATGGCTAGACCGCGCGTCCT
TTATAAACGAACTGATGACT -> TATAAACGAACTGATGACTA
ATTCCATTATCTGGCCCGAT -> TTCCATTATCTGGCCCGATA
TAAAACACAATTAACCACCG -> AAAACACAATTAACCACCGT
GGGTAGAACCCCTCCACTCC -> GGTAGAACCCCTCCACTCCC
TTGGCGTCATATGCCAGCAC -> TGGCGTCATATGCCAGCACT
GGTGAGCGATTTAGATACTT -> GTGAGCGATTTAGATACTTC
AGATTAACGTTGGTAACCAG -> GATTAACGTTGGTAACCAGG
AACCGTAATCCACTCCGTGT -> ACCGTAATCCACTCCGTGTT
CGCGTACTCTAGTCCAGGAT -> GCGTACTCTAGTCCAGGATC
CATCCTCTGTATGAGGGCCT -> ATCCTCTGTATGAGGGCCTG
AAATGACTCGTCGCGTACTC -> AATGACTCGTCGCGTACTCT
TCAACCGTAATCCACTCCGT -> CAACCGTAATCCACTCCGTG
GATTCCATTATCTGGCCCGA -> ATTCCATTATCTGGCCCGAT
GCAGCTGAATGGGTCAAAGC -> CAGCTGAATGGGTCAAAGCG
TAAGGAACATCCTCGTCTTC -> AAGGAACATCCTCGTCTTCG
AGCCATAGTGTTCCTCAACC -> GCCATAGTGTTCCTCAACCG
ACATCAGGACAAATGACTCG -> CATCAGGACAAATGACTCGT
CCACTCCCATTGATCCTTCC -> CACTCCCATTGATCCTTCCT
TTCTAGATAGGAGTGGGAAC -> TCTAGATAGGAGTGGGAACA
CTTATATGTCGGTGAGCGAT -> TTATATGTCGGTGAGCGATT
GCAGGTTGTAAAACACAATT -> CAGGTTGTAAAACACAATTA
GCATAAACGTTTACATATAT -> CATAAACGTTTACATATATT
TGAATGGGTCAAAGCGGATG -> GAATGGGTCAAAGCGGATGG
CCAGCACTGTTCGTTGCGAA -> CAGCACTGTTCGTTGCGAAT
TAGCTAACTGGGTGTTTTTA -> AGCTAACTGGGTGTTTTTAG
TTACAGAATGCTTAGCCTAG -> TACAGAATGCTTAGCCTAGT
CCGAACCACTAGGACATCAG -> CGAACCACTAGGACATCAGG
GTCAGGCGGTGGCTAGCTGT -> TCAGGCGGTGGCTAGCTGTC
CTGGCAATTTCACCGTTAGA -> TGGCAATTTCACCGTTAGAT
TACTCTAGTCCAGGATCGGA -> ACTCTAGTCCAGGATCGGAA
TAGACCGCGCGTCCTCGTGT -> AGACCGCGCGTCCTCGTGTG
ATCCATAGTGCCGAACCACT -> TCCATAGTGCCGAACCACTA
ACCCTCGCGATTTTCTAGAT -> CCCTCGCGATTTTCTAGATA
GGCTAGACCGCGCGTCCTCG -> GCTAGACCGCGCGTCCTCGT
GGATTCCATTATCTGGCCCG -> GATTCCATTATCTGGCCCGA
TCTTGGGCGTCATCCTCTGT -> CTTGGGCGTCATCCTCTGTA
TGTGAGAAGCTTATATGTCG -> GTGAGAAGCTTATATGTCGG
CAAGGGTAGAACCCCTCCAC -> AAGGGTAGAACCCCTCCACT
CCTCGTCTTCGACTGGCAAT -> CTCGTCTTCGACTGGCAATT
TCGCGATTTTCTAGATAGGA -> CGCGATTTTCTAGATAGGAG
AGTGCCTAGCCCCAAGGACG -> GTGCCTAGCCCCAAGGACGC
AAGGGTAGAACCCCTCCACT -> AGGGTAGAACCCCTCCACTC
ACACTTCAGGCAGGGCGTTA -> CACTTCAGGCAGGGCGTTAT
ACAGAATGCTTAGCCTAGTA -> CAGAATGCTTAGCCTAGTAA
GGCTAGCTGTCAGTGCCTAG -> GCTAGCTGTCAGTGCCTAGC
CTCCGTGTTTGCGGCATAAA -> TCCGTGTTTGCGGCATAAAC
TGTTCCTCAACCGTAATCCA -> GTTCCTCAACCGTAATCCAC
ACTGGCAATTTCACCGTTAG -> CTGGCAATTTCACCGTTAGA
ACTTTTGCAGCTGAATGGGT -> CTTTTGCAGCTGAATGGGTC
GATGCCATCCGCCATGTCAG -> ATGCCATCCGCCATGTCAGT
TCCACTCCGTGTTTGCGGCA -> CCACTCCGTGTTTGCGGCAT
AACCACCGTACGACTTTTGC -> ACCACCGTACGACTTTTGCA
CTGAATGGGTCAAAGCGGAT -> TGAATGGGTCAAAGCGGATG
CTCTGTATGAGGGCCTGGGA -> TCTGTATGAGGGCCTGGGAC
GGCAGGGCGTTATAAACGAA -> GCAGGGCGTTATAAACGAAC
TATGAGGGCCTGGGACCCAG -> ATGAGGGCCTGGGACCCAGT
CGGTGGCTAGCTGTCAGTGC -> GGTGGCTAGCTGTCAGTGCC
GGGGTCTGTTAGACTGGTAG -> GGGTCTGTTAGACTGGTAGC
CCGCCATGTCAGTTGTCCAG -> CGCCATGTCAGTTGTCCAGT
GCCATCCGCCATGTCAGTTG -> CCATCCGCCATGTCAGTTGT
GCGTCCTCGTGTGATGAGAC -> CGTCCTCGTGTGATGAGACA
GTCGGTGAGCGATTTAGATA -> TCGGTGAGCGATTTAGATAC
AGATATACTACGGAATCCCT -> GATATACTACGGAATCCCTT
TTGCGGCATAAACGTTTACA -> TGCGGCATAAACGTTTACAT
TATCATATCGTCGCAAGTGG -> ATCATATCGTCGCAAGTGGG
CGACCCAACACGGGAGTATT -> GACCCAACACGGGAGTATTG
GGAACCGTTGGTCAGTCAGG -> GAACCGTTGGTCAGTCAGGC
CTCGTTGATAGCTGCCTGCG -> TCGTTGATAGCTGCCTGCGA
CACTCCCATTGATCCTTCCT -> ACTCCCATTGATCCTTCCTT
CCATAGTGTTCCTCAACCGT -> CATAGTGTTCCTCAACCGTA
GCCTGGAGTACACTTCAGGC -> CCTGGAGTACACTTCAGGCA
GCCTGCGAGATTAACGTTGG -> CCTGCGAGATTAACGTTGGT
TAGACTGGTAGCTAACTGGG -> AGACTGGTAGCTAACTGGGT
CAATACTAAAGCCCGTGCAT -> AATACTAAAGCCCGTGCATC
GAATGCTTAGCCTAGTAAAA -> AATGCTTAGCCTAGTAAAAA
AATACTAAAGCCCGTGCATC -> ATACTAAAGCCCGTGCATCA
AATCCATAGTGCCGAACCAC -> ATCCATAGTGCCGAACCACT
GTCTTGGGCGTCATCCTCTG -> TCTTGGGCGTCATCCTCTGT
ATACGGGTTTAATTCGCCAT -> TACGGGTTTAATTCGCCATA
TATACTACGGAATCCCTTTG -> ATACTACGGAATCCCTTTGC
ATCGTCGCAAGTGGGGGTCT -> TCGTCGCAAGTGGGGGTCTG
CACAATTAACCACCGTACGA -> ACAATTAACCACCGTACGAC
TAACCACCGTACGACTTTTG -> AACCACCGTACGACTTTTGC
GGTTTTGGCGCCAGGATTCC -> GTTTTGGCGCCAGGATTCCA
ACTAGGACATCAGGACAAAT -> CTAGGACATCAGGACAAATG
CGCGATTTTCTAGATAGGAG -> GCGATTTTCTAGATAGGAGT
ATCCGCCATGTCAGTTGTCC -> TCCGCCATGTCAGTTGTCCA
CTGCCTGCGAGATTAACGTT -> TGCCTGCGAGATTAACGTTG
ATACTACGGAATCCCTTTGC -> TACTACGGAATCCCTTTGCA
ATAAACGTTTACATATATTC -> TAAACGTTTACATATATTCC
TGTAAAACACAATTAACCAC -> GTAAAACACAATTAACCACC
TGTTTTTAGTCAATTTCGGT -> GTTTTTAGTCAATTTCGGTT
AATGCTTAGCCTAGTAAAAA -> ATGCTTAGCCTAGTAAAAAC
TCAGGCAGGGCGTTATAAAC -> CAGGCAGGGCGTTATAAACG
CTAGGACATCAGGACAAATG -> TAGGACATCAGGACAAATGA
TTACATATATTCCGACCCAA -> TACATATATTCCGACCCAAC
TCAGTCAGGCGGTGGCTAGC -> CAGTCAGGCGGTGGCTAGCT
CACCGTACGACTTTTGCAGC -> ACCGTACGACTTTTGCAGCT
CACTCCGTGTTTGCGGCATA -> ACTCCGTGTTTGCGGCATAA
CACGGGAGTATTGCAGGTTG -> ACGGGAGTATTGCAGGTTGT
CCACCGTACGACTTTTGCAG -> CACCGTACGACTTTTGCAGC
TTATATGTCGGTGAGCGATT -> TATATGTCGGTGAGCGATTT
GCGGCATAAACGTTTACATA -> CGGCATAAACGTTTACATAT
CAGTGAATCCATAGTGCCGA -> AGTGAATCCATAGTGCCGAA
TAAGACCTGTCGGCGTCTTG -> AAGACCTGTCGGCGTCTTGG
AGGTAATCAATGTGCGCTCG -> GGTAATCAATGTGCGCTCGT
AATCCCTTTGCACTCGTGTT -> ATCCCTTTGCACTCGTGTTG
TATGTCGGTGAGCGATTTAG -> ATGTCGGTGAGCGATTTAGA
GATGACTAAGTAAATGGCTA -> ATGACTAAGTAAATGGCTAG
GAATTAAGACCTGTCGGCGT -> AATTAAGACCTGTCGGCGTC
TCCGACCCAACACGGGAGTA -> CCGACCCAACACGGGAGTAT
TGTCAGTGCCTAGCCCCAAG -> GTCAGTGCCTAGCCCCAAGG
GTTTTGGCGCCAGGATTCCA -> TTTTGGCGCCAGGATTCCAT
GGGCGTCATCCTCTGTATGA -> GGCGTCATCCTCTGTATGAG
GGGTCAAAGCGGATGGAAAA -> GGTCAAAGCGGATGGAAAAT
GACAGATCTGGTAAAGTATC -> ACAGATCTGGTAAAGTATCA
CGGCAGCTATTTCTTATAAC -> GGCAGCTATTTCTTATAACT
AGTGTTCCTCAACCGTAATC -> GTGTTCCTCAACCGTAATCC
CCAGGATTCCATTATCTGGC -> CAGGATTCCATTATCTGGCC
ACTAAGTAAATGGCTAGACC -> CTAAGTAAATGGCTAGACCG
TAGTCCAGGATCGGAACGAC -> AGTCCAGGATCGGAACGACC
ATAGGAGTGGGAACAAGGGT -> TAGGAGTGGGAACAAGGGTA
CCTCCACTCCCATTGATCCT -> CTCCACTCCCATTGATCCTT
CTCCCATTGATCCTTCCTTC -> TCCCATTGATCCTTCCTTCG
CAAGATATACTACGGAATCC -> AAGATATACTACGGAATCCC
TCGTTGATAGCTGCCTGCGA -> CGTTGATAGCTGCCTGCGAG
TTTATTTACAGAATGCTTAG -> TTATTTACAGAATGCTTAGC
GCCTGGGACCCAGTGAATCC -> CCTGGGACCCAGTGAATCCA
GCTATTTCTTATAACTCGTT -> CTATTTCTTATAACTCGTTG
CTTCCTTCGGTTTTGGCGCC -> TTCCTTCGGTTTTGGCGCCA
TTGGTAACCAGGTAATCAAT -> TGGTAACCAGGTAATCAATG
TCAGGACAAATGACTCGTCG -> CAGGACAAATGACTCGTCGC
TCTTCGACTGGCAATTTCAC -> CTTCGACTGGCAATTTCACC
GTCAGTGCCTAGCCCCAAGG -> TCAGTGCCTAGCCCCAAGGA
GCCAGCACTGTTCGTTGCGA -> CCAGCACTGTTCGTTGCGAA
ATGTGCGCTCGTGAAGTTTT -> TGTGCGCTCGTGAAGTTTTT
TGGCGTCATATGCCAGCACT -> GGCGTCATATGCCAGCACTG
CTTGGGCGTCATCCTCTGTA -> TTGGGCGTCATCCTCTGTAT
AGTAAAAACTATGACTTGAA -> GTAAAAACTATGACTTGAAA
CCCAAGGACGCCTGGAGTAC -> CCAAGGACGCCTGGAGTACA
CTAAGTAAATGGCTAGACCG -> TAAGTAAATGGCTAGACCGC
CGGAATCCCTTTGCACTCGT -> GGAATCCCTTTGCACTCGTG
CTACCAATACTAAAGCCCGT -> TACCAATACTAAAGCCCGTG
ACCCAGTGAATCCATAGTGC -> CCCAGTGAATCCATAGTGCC
GGTTGTAAAACACAATTAAC -> GTTGTAAAACACAATTAACC
GTGTTGGCGTCATATGCCAG -> TGTTGGCGTCATATGCCAGC
TCAAAGCGGATGGAAAATGC -> CAAAGCGGATGGAAAATGCT
GGCGTCTTGGGCGTCATCCT -> GCGTCTTGGGCGTCATCCTC
ACTAAAGCCCGTGCATCACG -> CTAAAGCCCGTGCATCACGC
CGATTTAGATACTTCAGCCA -> GATTTAGATACTTCAGCCAT
AAGGACGCCTGGAGTACACT -> AGGACGCCTGGAGTACACTT
